border_size=1
usage=map

Gg          , Gg          , Gg          , Gg          , Ggf         , Gg          , Gg          , Gg          , Re          , Gg          , Gg          , Gg          , Gg          , Gg          , Gs          , Gs^Fp       , Gs^Fp       , Gs^Fmf      , Gs^Fdf      , Gs^Fdf      , Gs^Fdf      , Gs^Fdf      , Gs^Fdf      , Gs^Fdf      , Gs^Fp       , Gs^Fp       , Gs^Fdf      , Gs^Fdf      , Gs^Fdf      , Gs^Fdf      , Gs^Fp       , Gs^Fp       , Gs^Fp       
Gg          , Gg          , Gg          , Ggf         , Ggf         , Gg          , Gg          , Re          , Gg          , Gs          , Ggf         , Ggf         , Gg          , Gg          , Gg          , Gs          , Ggf         , Gs^Fp       , Gs^Fp       , Gs^Fmf      , Gs^Fmf      , Gs^Fmf      , Gs^Fp       , Gs^Fp       , Gs^Fp       , Gs^Fp       , Gs^Fp       , Gs^Fdf      , Gs^Fmf      , Gs^Fp       , Gs^Fp       , Gs^Fp       , Gs^Fp       
Gg          , Gg          , Gg          , Ggf         , Gs          , Gg          , Re          , Re          , Gg          , Ggf         , Ggf         , Gg          , Gg          , Gg          , Gg          , Gs^Fp       , Gs^Fp       , Gg^Ve       , Ggf         , Gs^Fmf      , Gs^Fp       , Gs^Fp       , Gs^Fp       , Gs^Fp       , Cv          , Gs^Fp       , Gs^Fp       , Gs^Fdf      , Gs^Fmf      , Gs^Fdf      , Gs^Fp       , Gs^Fp       , Gs^Fp       
Ww          , Ww          , Ww          , Gg          , Ww          , Gg          , Re          , Gg          , Gg          , Ggf         , Gg          , Gg          , Gg          , Gg          , Gg          , Gs          , Gs          , Gs^Fp       , Ggf         , Gs^Fmf      , Cv          , Gs^Fp       , Gs^Fp       , Cv          , 2 Kv        , Cv          , Gs^Fp       , Gs^Fp       , Gs^Fdf      , Gs^Fp       , Gs^Fp       , Gs^Fp       , Gg          
Ww          , Ww          , Ww          , Ww          , Ww          , Ww          , Ww^Bw|      , Ww          , Ww          , Gg          , Ww          , Gg          , Ds          , Gg          , Gg          , Gg          , Gg          , Gs          , Gs^Fp       , Gs^Fp       , Gs^Fp       , Gs^Fp       , Gs^Fp       , Cv          , Cv          , Cv          , Gs^Fp       , Gs^Fp       , Gs^Fdf      , Gs^Fdf      , Gs^Fmf      , Gs^Fp       , Gs^Fp       
Wo          , Wo          , Wo          , Ww          , Wo          , Ww          , Wo^Bw|      , Ww          , Ww          , Ww          , Ww          , Ww          , Ww          , Ds          , Ds          , Ds          , Ds          , Gs          , Gs^Fp       , Gs^Fp       , Gg^Ve       , Gs^Fmf      , Gs^Fmf      , Gs^Fp       , Gs^Fp       , Gs^Fp       , Gs^Fp       , Gs^Fdf      , Gg^Ve       , Gs^Fdf      , Gs^Fmf      , Gs^Fp       , Gg          
Ww          , Wo          , Ww          , Wo          , Wo          , Wo          , Wo^Bw|      , Wo          , Wo          , Ww          , Wo          , Ww          , Ww          , Ds          , Ww          , Ds          , Ds          , Gs^Fp       , Ds          , Gs^Fp       , Gs^Fp       , Gs^Fp       , Gs^Fp       , Gs^Fp       , Gs^Fp       , Gs^Fp       , Gs^Fp       , Gs^Fp       , Gs^Fdf      , Gs^Fdf      , Gs^Fmf      , Gs^Fp       , Gs^Fp       
Ww          , Ww          , Ww          , Ww          , Ww          , Wo          , Ww^Bw|      , Wo          , Wo          , Wo          , Wo          , Wo          , Wo          , Ww          , Ww          , Ww          , Ww          , Ss          , Ds          , Ds          , Hd          , Hh^Fp       , Gs^Fp       , Cv          , Gs^Fp       , Cv          , Gs^Fp       , Gs^Fp       , Gs^Fdf      , Gs^Fdf      , Gs^Fmf      , Gs^Fp       , Gs^Fp       
Gs          , Ww          , Ww          , Ww          , Ww          , Ww          , Ww^Bw|      , Ww          , Ww          , Wo          , Ww          , Wo          , Wo          , Wo          , Wo          , Ww          , Ww          , Ww          , Ww          , Ds          , Ds          , Hd          , Hh^Fp       , Gs^Fp       , Gg^Ve       , Gs^Fp       , Gs^Fp       , Gs^Fp       , Gs^Fmf      , Gs^Fmf      , Gg^Ve       , Gs^Fp       , Gs^Fp       
Gs          , Gs          , Gs          , Gs          , Gs          , Ww          , Re          , Ww          , Ww          , Ww          , Ww          , Ww          , Ww          , Wo          , Wo          , Wo          , Wo          , Ww          , Ww          , Ds          , Ds          , Ds          , Gg          , Gs^Fp       , Gs^Fp       , Gs^Fmf      , Gs^Fp       , Gs^Fp       , Gs^Fdf      , Gs^Fmf      , Gs^Fp       , Gg          , Gs^Fp       
Gs          , Gs          , Gs          , Gs          , Gs          , Gs          , Re          , Gs          , Gs          , Gs          , Gs          , Ww          , Ww          , Ww          , Wo          , Wo          , Wo          , Wo          , Ww          , Ww          , Ss          , Gs          , Gs          , Gg          , Gs^Fp       , Gs^Fmf      , Gs^Fp       , Gs^Fp       , Gs^Fp       , Gs^Fp       , Gs^Fp       , Gg          , Gg          
Hh^Fp       , Gs          , Hh^Fp       , Gs          , Gs          , Re          , Gs          , Gs          , Gs          , Gs          , Gs          , Ww          , Ww          , Ww          , Wo          , Wo          , Wo          , Ww          , Ww          , Ww          , Ss          , Gs^Ft       , Gs          , Gg          , Gs^Fp       , Gs^Fp       , Gs^Fp       , Gs^Fp       , Gs^Fp       , Gg          , Gg          , Gs^Fp       , Gg          
Mm          , Hh^Fp       , Mm          , Hh^Fp       , Mm          , Re          , Hh^Fp       , Hh^Fp       , Hh^Fp       , Gs          , Gs          , Ss          , Ww          , Ww          , Ww          , Wo          , Wo          , Wo          , Ww          , Ww          , Ww          , Gs          , Ds          , Gg          , Gg          , Gg          , Gs^Fp       , Gg^Ve       , Gs^Fp       , Gs^Fp       , Gg          , Gs^Fp       , Gg          
Mm          , Mm          , Ce          , Ce          , Ce          , Hh^Fp       , Mm          , Mm          , Mm          , Hh^Fp       , Ss          , Ss          , Ss          , Ww          , Ww          , Wo          , Wo          , Ww          , Ww          , Ww          , Ss          , Ds          , Gs^Ft       , Gs          , Gg          , Gg          , Ggf         , Gs^Fp       , Ggf         , Gs^Fp       , Gg          , Gg          , Gs^Fp       
Mm          , Mm          , Ce          , 3 Ke        , Ce          , Hh^Fp       , Mm          , Mm^Vhh      , Mm          , Hh^Fp       , Ss          , Ss          , Ss          , Ww          , Ww          , Wo          , Wo          , Wo          , Ww          , Ww          , Ss          , Gs^Ft       , Gs          , Gs          , Gs          , Gg          , Gs^Fp       , Gs^Fp       , Gg          , Gs^Fp       , Gg          , Gs^Fp       , Gs^Fp       
Mm          , Mm          , Mm          , Ce          , Mm          , Mm          , Mm^Xm       , Mm          , Mm          , Mm          , Hh^Fp       , Hh^Fp       , Gs          , Gs          , Ww          , Ww          , Wo          , Wo          , Ww          , Ww          , Ww          , Ds          , Gs          , Gs^Vht      , Gs          , Gg          , Cv          , Cv          , Cv          , Gs^Fp       , Gg          , Gg          , Gs^Fp       
Mm          , Mm          , Mm          , Mm          , Mm          , Mm^Xm       , Mm          , Mm          , Mm          , Ce          , Mm          , Hh^Fp       , Gs          , Ww          , Ww          , Wo          , Wo          , Wo          , Ww          , Ww          , Ss          , Gs          , Ds          , Gs          , Gg          , Gg          , Cv          , Ke          , Dd^Vdt      , Gs^Fp       , Gg          , Gs^Fp       , Gs^Fp       
Mm          , Mm          , Mm          , Mm          , Mm          , Mm^Xm       , Mm          , Mm          , Ce          , Ke          , Hh^Fp       , Hh^Fp       , Gs          , Ww          , Ww          , Wo          , Wo          , Ww          , Ww          , Ww          , Ww          , Ds          , Ds          , Gg          , Gg          , Gg          , Gg          , Cv          , Gs^Fp       , Gg          , Gg          , Gg          , Gs^Fp       
Mm          , Mm          , Mm          , Mm          , Mm^Xm       , Mm^Xm       , Mm          , Mm          , Mm          , Mm          , Hh^Fp       , Ss          , Ss          , Ww          , Ww          , Wo          , Wo          , Wo          , Ww          , Ww          , Ss          , Ds          , Gs          , Gs          , Ds          , Gg          , Gg          , Gg          , Gs^Fp       , Gs^Fp       , Gg          , Gs^Fp       , Gg          
Mm          , Mm          , Mm^Xm       , Mm^Xm       , Mm          , Mm^Xm       , Mm^Xm       , Mm          , Mm^Xm       , Mm^Xm       , Hh^Fp       , Ss          , Ss          , Ww          , Ww          , Ww          , Wo          , Wo          , Ww          , Ww          , Ss          , Gs          , Gs          , Ds          , Dd^Vdt      , Ds          , Ds          , Gg          , Gg          , Gs^Fp       , Gg          , Gs^Fp       , Gs^Fp       
Mm          , Mm          , Hh^Fp       , Mm          , Mm          , Mm          , Mm          , Mm^Xm       , Mm          , Mm          , Ss          , Ss          , Gs^Fp       , Ss          , Ww          , Ww          , Wo          , Wo          , Wo          , Ww          , Ww          , Gs          , Gs^Ft       , Ds          , Ds          , Ds          , Gg          , Gg          , Gg          , Gg          , Gg          , Gg          , Gg          
Mm          , Mm          , Hh^Fp       , Mm          , Mm          , Ha^Fma      , Mm          , Mm          , Hh^Fp       , Ss          , Ss          , Ss          , Ss          , Gs          , Ww          , Ww          , Wo          , Wo          , Ww          , Ww          , Ww          , Ss          , Gs          , Gs          , Ds          , Gs          , Gg          , Gg^Fet      , Gg          , Gg          , Gg          , Gs^Fp       , Gs^Fp       
Mm          , Mm          , Mm          , Mm          , Mm          , Mm          , Mm          , Hh^Fp       , Hh^Fp       , Ss          , Hh^Fp       , Hh^Fp       , Gs          , Ss          , Ww          , Ww          , Wo          , Wo          , Wo          , Ww          , Ww          , Ss          , Gs          , Gs          , Gs          , Gs          , Gs          , Gg          , Gg          , Gg^Fet      , Gg          , Gg          , Gs^Fp       
Mm          , Hh^Fp       , Mm          , Mm          , Mm          , Mm          , Hh^Fp       , Mm          , Hh^Fp       , Hh^Fp       , Hh^Fp       , Hh^Fp       , Ss          , Ww          , Ww          , Ww          , Wo          , Wo          , Wo          , Ww          , Ww          , Ww          , Gs          , Gs          , Gs          , Ds          , Ds          , Ds          , Ds          , Gg          , Gg          , Gs^Fp       , Gg          
Mm          , Mm          , Mm          , Hh^Fp       , Mm          , Mm          , Hh^Fp       , Hh^Fp       , Ss          , Hh^Fp       , Ss          , Ss          , Ss          , Ss          , Ww          , Ww          , Ww          , Wo          , Wo          , Wo          , Ww^Bw/      , Ww^Bw/      , Ww          , Gs          , Gs          , Gs          , Ds          , Dd^Vda      , Ds          , Gg          , Gg          , Gg          , Gg          
Mm          , Mm          , Hh^Fp       , Mm          , Hh^Fp       , Hh^Fp       , Gs          , Gs          , Gs          , Ss          , Gs          , Gs          , Gs          , Gs          , Ss          , Ww          , Ww          , Wo          , Wo^Bw/      , Wo^Bw/      , Wo          , Ww          , Ww          , Ss          , Ss          , Gs          , Ds          , Ds          , Gg          , Ds          , Gg          , Gs^Fp       , Gs^Fp       
Mm          , Mm          , Hh^Fp       , Hh^Fp       , Gg          , Gg          , Gg          , Gg          , Gs          , Gs          , Gs          , Gs          , Gg          , Gs          , Gs          , Ww          , Ww^Bw/      , Ww^Bw/      , Wo          , Wo          , Wo          , Ww          , Ww          , Ww          , Ss          , Gs          , Ds          , Ds          , Gg          , Gg          , Gg          , Gs^Fp       , Gg          
Mm          , Mm          , Mm          , Hh^Fp       , Hh^Fp       , Gg          , Gg          , Gg          , Gg          , Gg          , Gg          , 1 Gg        , Gg          , Gs          , Gs          , Gs          , Ww          , Ww          , Ww          , Wo          , Wo          , Wo          , Ww          , Ww          , Ww          , Gs          , Ds          , Gg          , Gs^Fp       , Gs^Fp       , Gg          , Gg          , Gg          
Hh^Fp       , Hh^Fp       , Hh^Fp       , Hh^Fp       , Gg          , Gg          , Gg          , Gg          , Gg          , Gg          , Gs          , Gg          , Gg          , Gg          , Gs          , Gs          , Ss          , Ww          , Ww          , Wo          , Wo          , Wo          , Wo          , Ww          , Ww          , Ss          , Ds          , Gg          , Gs^Fp       , Gs^Fp       , Gs^Fp       , Gs^Fp       , Gs^Fp       
Gg          , Hh^Fp       , Gg          , Gg          , Gg          , Gg          , Ds          , Ds          , Gg          , Gs          , Gs          , Gg          , Gg          , Ds          , Ds          , Gs          , Gs          , Ww          , Ww          , Ww          , Wo          , Wo          , Wo          , Ww          , Wo          , Ww          , Ss          , Gg          , Gs^Fp       , Gs^Fp       , Gs^Fp       , Gs^Fmf      , Gs^Fmf      
Gg          , Gg          , Gg          , Gg          , Gg          , Ds          , Ds          , Ds          , Gg          , Gg          , Gs          , Gs^Vht      , Gg          , Gg          , Ds          , Ds          , Gs          , Ss          , Ww          , Ww          , Ww          , Wo          , Wo          , Wo          , Wo          , Ww          , Ww          , Gg          , Gg          , Gs^Fp       , Gg          , Gs^Fp       , Gs^Fp       
Gg          , Gg          , Gg          , Gg          , Gg          , Gg          , Gg          , Gg          , Gg          , Gg          , Gg          , Gg          , Gg          , Gg          , Gg          , Gs          , Gs          , Ss          , Ss          , Ss          , Ww          , Ww          , Wo          , Wo          , Wo          , Wo          , Wo          , Ww          , Ww          , Gg          , Ss          , Gg          , Gg          
