border_size=1
usage=map

Ss          , Ss          , Ss          , Ss          , Ss          , Ss          , Ss          , Ss          , Ss          , Ss          , Ss          , Ss          , Ss          , Ss          , Ww          , Ds          , Ds          , Ds          , Rr          , Rr          , Rr          , Rr          , Rr          , Rr          , Rr          , Rr          , Rr          , Rr          
Ss          , Ss          , Ss          , Ss          , Ss          , Ss          , Ss          , Ss          , Gg          , Ss          , Gg          , Ss          , Ss          , Ww          , Ww          , Wwf         , Ds          , Ds          , Ch          , Rr          , Rr          , Rr          , Rr^Vd       , Rr          , Rr          , Rr          , Rr          , Rr          
Gg          , Gg          , Gg          , Ss          , Ss          , Ss          , Ss          , Gg          , Gg          , Gg          , Gg          , Gg          , Ss          , Ss          , Ww          , Wwf         , Wwf         , Ds          , Ch          , 4 Kh        , Ch          , Rr          , Rr          , Rr          , Ch          , Rr          , Rr          , Rr          
Gg          , Gg          , Ss          , Ss          , 2 Kh        , Ss          , Ss          , Ss          , Gg          , Gg          , Gg          , Ss^Vhs      , Ss          , Ss          , Ww          , Ww          , Wwf         , Ds          , Rr          , Ch          , Rr          , Rr          , Rr          , Ch          , 3 Kh        , Ch          , Rr          , Rr          
Ss          , Gg          , Gg          , Ss          , Ss          , Ss          , Ss          , Gg          , Gs          , Gg          , Gg          , Gg          , Ss          , Gs          , Gs          , Wwf         , Ds          , Ds          , Rr          , Rr          , Rr          , Rr          , Rr          , Ch          , Ch          , Ch          , Rr          , Rr          
Ss          , Gg          , Gg          , Ss          , Gg          , Ss          , Gg          , Gg          , Gg          , Gg          , Ds          , Gg          , Gs^Ft       , Gs          , Gs          , Ds          , Ds          , Ds          , Ch          , Rr          , Rr          , Rr          , Rr          , Rr          , Rr          , Rr          , Rr          , Rr          
Gg          , Ss          , Ss          , Gg          , Gg          , Gg          , Gg^Vo       , Gg          , Gg          , Ds          , Gg          , Gg          , Gs^Ft       , Gs^Ft       , Gg          , Gg          , Rd          , Rd          , Ds          , Rr          , Rr          , Ch          , 5 Kh        , Rr          , Rr          , Rr^Vd       , Rr          , Rr          
Gg          , Gg          , Gg          , Gg          , Gg          , Gg          , Ds          , Ds          , Ds          , Gg          , Gg          , Gs          , Gg          , Gs^Ft       , Gg          , Rd          , Gg          , Ds          , Ds          , Ds          , Ds          , Ch          , Ch          , Ch          , Rr          , Rr          , Rr          , Rr          
Gs^Fp       , Gg          , Gs^Fp       , Gg          , Gg          , Gg          , Ds          , Dd^Do       , Ds          , Gg          , Gg          , Gg          , Re          , Gg          , Gs          , Gg          , Gg          , Gg          , Gg          , Ds          , Ds          , Ds          , Ds          , Rr          , Rr          , Rr          , Rr          , Rr          
Gs^Fmf      , Gs^Fp       , Gs^Fp       , Gg          , Ds          , Gg          , Ds          , Ds          , Gg          , Gg          , Gg          , Gg          , Gg          , Gg          , Gs          , Gs          , Gg          , Gg          , Ds          , Gg          , Gg          , Ds          , Ds          , Ds          , Ds          , Ch          , Rr          , Rr          
Gs^Fp       , Gs^Fp       , Gg          , Gg          , Ds          , Ds          , Gg          , Gg          , Re          , Re          , Gg          , Gg          , Gg          , Gg          , Gg          , Gs          , Gg          , Ds          , Ds          , Gg          , Gg          , Gg          , Gg          , Ds          , Ds          , Ds          , Ds          , Rr          
Gg          , Gg          , Gg^Vo       , Gg          , Gg          , Gg          , Gg          , Gg          , Gg          , Gg          , Gg          , Gs^Fp       , Gs^Fp       , Gg^Vo       , Gs^Fp       , Gg          , Gg          , Gg          , Gg          , Gg          , Gg          , Gg          , Re^Gvs      , Gg          , Gg          , Ds          , Ds          , Ds          
Gg          , Gg          , Gg          , Gg          , Re          , Re          , Gg          , Gg          , Gg          , Gg          , Gs^Fp       , Gs^Fp       , Gs^Fmf      , Gs^Fp       , Gs^Fp       , Gg          , Gg          , Gg          , Gg          , Gg          , Gg          , Gg          , Gg          , Re^Gvs      , Gg          , Gg          , Gg          , Ds          
Gg          , Gg          , Gg          , Re          , Gg          , Gg          , Gg          , Gg          , Ww          , Gg          , Gg          , Gs^Fp       , Gs^Fp       , Gs^Fp       , Gg          , Gg          , Gg          , Gs^Fp       , Gs^Fp       , Gs^Fp       , Gg          , Gg          , Gg          , Gg          , Gg          , Gg          , Gg          , Gg          
Gg          , Gg          , Gg          , Gg          , Gg          , Gg^Vo       , Gg          , Ww          , Ww          , Gg          , Gg          , Gg          , Gg          , Gg          , Ww          , Wwf         , Gg          , Gs^Fp       , Gs^Fmf      , Gs^Fp       , Gg          , Gg^Vo       , Gg          , Gg          , Gg          , Gg          , Gg          , Gg          
Gg          , Gg          , Gg          , Ds          , Gg          , Gg          , Gg          , Gg          , Gg          , Ww          , Ww          , Gg          , Gg          , Gg          , Gg          , Ww          , Gg          , Gs^Fp       , Gs^Fp       , Gs^Fp       , Gg          , Gg          , Gg          , Gs^Fp       , Gs^Fp       , Gs^Fp       , Gs^Fp       , Gg          
Gg          , Gg          , Gg          , Gg          , Gg          , Gs^Fp       , Gs^Fp       , Gs^Fp       , Gg          , Wwf         , Gg          , Gg          , Gg          , Gg^Vo       , Gg          , Ww          , Ww          , Gg          , Gg          , Gg          , Gg          , Gg          , Gs^Fp       , Gs^Fp       , Gs^Fms      , Gs^Fp       , Gg          , Gg          
Gg          , Ds          , Gg          , Gg          , Gg          , Gg          , Gg          , Gs^Fp       , Gg          , Gg          , Gg          , Gg          , Gg          , Gg          , Gg          , Gg          , Ww          , Ww          , Gg          , Gg          , Gs          , Gg          , Gg          , Gs^Fp       , Gs^Fp       , Gs^Fmf      , Gs^Fp       , Gg          
Gg          , Ds          , Gg          , Ds          , Gg          , Gg          , Gg          , Gg          , Gg          , Gg          , Gs^Fp       , Gs^Fp       , Gg          , Gg          , Gs^Fp       , Gg          , Gg          , Gg          , Gs^Fp       , Gg          , Gg          , Gg          , Gg          , Gg          , Gg          , Gg^Vo       , Gg          , Gg          
Gg          , Gg          , Gg          , Ds          , Ds          , Ds          , Gg          , Gg          , Gg          , Gg          , Gg          , Gg          , Ds          , Gg          , Gg          , Gg          , Gg          , Gs^Fp       , Gs^Fms      , Gs^Fp       , Gg          , Gg          , Gs          , Gg          , Gg          , Gg          , Gg          , Gg          
Gg          , Gg          , Ds          , Ds          , Dd^Vdt      , Ds          , Ds          , Gg          , Ds          , Ds          , Gg          , Gg          , Gg          , Gg          , Gg^Vo       , Gg          , Gg          , Gs^Fp       , Gs^Fp       , Gs^Fp       , Gg          , Gg          , Gs          , Gs          , Gg          , Gg          , Gg          , Gg          
Ds          , Gg          , Ds          , Ds          , Ds          , Ds          , Ds          , Gg          , Ds          , Gg          , Ds          , Ds          , Gg          , Gg          , Gg          , Gg          , Gg          , Gg          , Gs^Fp       , Gg          , Gg          , Gg          , Gs          , Gs          , Gg          , Gg          , Gg          , Gg          
Hd          , Ds          , Ds          , Ds          , Ds          , Ds          , Hd          , Ds          , Ds          , Ds          , Hd          , Ds          , Ds          , Gg          , Gg          , Gg          , Gg          , Gg          , Gg          , Gg          , Gg          , Gs          , Gs^Vht      , Gs          , Gg          , Gg          , Gg          , Gg          
Md          , Hd          , Hd          , Hd          , Hd          , Hd          , Ce          , Ce          , Ce          , Hd          , Ds          , Ds          , Ds          , Gg          , Ds          , Gg          , Gg          , Gg          , Gg          , Gg          , Gg          , Gg          , Gg          , Gg          , Ds          , Ds          , Gg          , Gg          
Md          , Md          , Md          , Md          , Md          , Hd          , Ce          , 1 Ke        , Ce          , Hd          , Hd          , Ds          , Ds          , Ds          , Dd^Dc       , Ds          , Ds          , Ds          , Gg          , Gg          , Gg          , Ds          , Gg          , Gg          , Ds          , Dd          , Ds          , Gg          
Mm          , Md          , Mm          , Md          , Md          , Hd          , Hd          , Ce          , Ds          , Hd          , Hd          , Hd          , Hd          , Ds          , Ds          , Ds          , Dd^Vda      , Ds          , Ds          , Gg          , Ds          , Gg          , Gg          , Ds          , Ds          , Ds          , Ds          , Gg          
Md^Xm       , Mm          , Mm          , Mm          , Md          , Md          , Hd          , Ds          , Ds          , Ds          , Ds          , Hd          , Hd          , Ds          , Ds          , Ds          , Ds          , Ds          , Hd          , Ds          , Ds          , Ds          , Gg          , Ds          , Gg          , Gg          , Gg          , Gg          
Md^Xm       , Mm          , Md^Xm       , Mm          , Mm          , Mm          , Mm          , Hd          , Hd          , Ds          , Ds          , Ds          , Ds          , Hd          , Hd          , Ds          , Ds          , Ds          , Ds          , Hd          , Hd          , Ds          , Ds          , Gg          , Gg          , Gg          , Gg          , Gg          
