border_size=1
usage=map

Ww          , Gg          , Gg          , Gs^Fp       , Gs^Fp       , Gs^Fp       , Gs^Fp       , Gs^Fp       , Gs^Fp       , Gs^Fp       , Gs^Fp       , Gs^Fp       , Gs^Fp       , Gs^Fp       , Gg          , Re          , Gg          , Gg          , Gs^Fp       , Gs^Fp       , Gs^Fp       , Gs^Fp       
Gg          , Ww          , Gg          , Gs^Fp       , Gs^Fp       , Gs^Fp       , Gs^Fp       , Gs^Fp       , Gs^Fp       , Gs^Fp       , Gs^Fp       , Gs^Fp       , Gg          , Gg          , Re          , Re          , Gg          , Gg          , Gs^Fp       , Gs^Fp       , Gs^Fp       , Gs^Fp       
Gg          , Ww          , Gg          , Gs^Fp       , Gs^Fp       , Gg^Ve       , Gs^Fp       , Gs^Fp       , Gs^Fmf      , Gs^Fp       , Gg          , Gg          , Re          , Re          , Gg          , Gg          , Gg          , Gg          , Gs^Fp       , Gs^Fp       , Gg^Ve       , Gs^Fp       
Gg          , Ww          , Gg          , Gs^Fp       , Gs^Fmf      , Gs^Fp       , Gs^Fp       , Gs^Fmf      , Gs^Fmf      , Gs^Fp       , Gg          , Re          , Gg          , Gg          , Ce          , Gg^Wm       , Ce          , Gg          , Gs^Fp       , Gs^Fp       , Gs^Fp       , Gs^Fp       
Gg          , Ww          , Gg          , Gs^Fp       , Gs^Fp       , Gs^Fp       , Gs^Fp       , Gs^Fp       , Gs^Fp       , Gs^Fp       , Gg          , Re          , Ce          , Gg          , Ce          , 1 Ke        , Ce          , Gs^Fp       , Gs^Fp       , Gs^Fmf      , Gs^Fmf      , Gs^Fp       
Gg          , Ww          , Ww          , Gg          , Gg          , Gg          , Gs^Fp       , Gg          , Gg          , Gg          , Gg          , Re          , Gg          , Gg          , Gg          , Ce          , Gg          , Gg          , Gs^Fp       , Gs^Fp       , Gs^Fp       , Gs^Fp       
Gg          , Gg          , Gg          , Ww          , Gg          , Gg          , Gg          , Gg          , Gg^Vc       , Gg          , Gg          , Re          , Gg          , Gs^Fp       , Gs^Fp       , Gg          , Gg          , Gg          , Gs^Fp       , Gs^Fp       , Gs^Fp       , Gg          
Ds          , Ds          , Gg          , Ww          , Ww          , Gg          , Gg          , Gg          , Re^Gvs      , Re^Gvs      , Gg          , Re          , Gg          , Gs^Fp       , Gg^Ve       , Gs^Fp       , Gg          , Gg          , Gg          , Gg          , Gg          , Gg          
Gg          , Ds          , Gg          , Ww          , Ww          , Ss          , Ss          , Gg          , Gg          , Gg          , Gg          , Re          , Gg          , Gg          , Gg          , Gg          , Gs^Fms      , Gg          , Gg          , Gg          , Re^Gvs      , Gg          
Gs^Fms      , Gg          , Gg          , Gg          , Ss          , Ww          , Ww          , Ss          , Ss          , Gs^Fms      , Gg          , Re          , Ce          , Gg          , Gs^Fms      , Gs^Fms      , Ww          , Gs^Fms      , Gg          , Re^Gvs      , Gg          , Gg          
Gs^Fms      , Gs^Fms      , Gg          , Gs          , Gs          , Ss          , Ss          , Ww          , Ww          , Ss          , Ss          , Re          , Ss          , Gs^Fms      , Ww          , Ww          , Ww          , Ww          , Ww          , Gg          , Ss          , Gg          
Gg          , Gg          , Gg          , Gs^Vht      , Gs          , Gs          , Gs          , Ss          , Ss          , Ww          , Ww          , Ww^Bw|      , Ww          , Ww          , Ww          , Ww          , Gs^Fms      , Ww          , Gg          , Ww          , Ww          , Ss          
Gg          , Gg          , Gs^Fms      , Gg          , Gg          , Gg          , Gg          , Gg          , Gs^Fms      , Ss          , Ss          , Ww^Bw|      , Ss          , Ww          , Gs^Fms      , Gs^Fms      , Gs^Fp       , Gg          , Gg          , Gg          , Gg          , Ww          
Gg          , Gs^Fms      , Gs^Fms      , Gs^Fms      , Gg          , Gg          , Gg^Fet      , Gg          , Gg          , Gs^Fms      , Gg          , Re          , Gg          , Gs^Fms      , Gs^Fp       , Gs^Fp       , Gs^Fp       , Gg          , Re^Gvs      , Re^Gvs      , Gg          , Gs^Fp       
Gg          , Gg          , Gs^Fms      , Gg          , Gg          , Gg          , Gg          , Gg          , Gg          , Gg          , Re          , Re          , Gg          , Gg          , Gg          , Gs^Fp       , Gg          , Gg          , Gg          , Gg          , Gg          , Gs^Fp       
Gs^Fms      , Gg          , Gg          , Gg          , Gg          , Gg          , Gg          , Gg          , Re          , Re          , Gg          , Gg          , Ds          , Ds          , Gg          , Gg          , Gg          , Gg          , Gg          , Gg^Vh       , Gg          , Gs^Fp       
Gs^Fms      , Gs^Fms      , Gg          , Gg^Vc       , Gg          , Gg          , Re          , Re          , Gg          , Gg          , Ce          , Gg          , Gg          , Ds          , Gg          , Gs          , Gs          , Gg          , Gg          , Gg          , Gg          , Gs^Fp       
Gs^Fms      , Gs^Fms      , Gg          , Gg          , Re          , Re          , Gg          , Gg          , Gg          , Ce          , 2 Ke        , Ce          , Gs^Fms      , Gg          , Gg          , Gs^Vht      , Gs          , Gg          , Gg          , Gg          , Gg          , Gs^Fp       
Gg          , Gg          , Re          , Re          , Gg          , Gg          , Gs^Fp       , Gg          , Gg          , Ce          , Ce          , Ce          , Gs^Fms      , Gg          , Gs^Fp       , Gg          , Gg          , Gg          , Gg          , Gg          , Gg          , Gs^Fp       
Re          , Re          , Gg          , Gg          , Gs^Fp       , Gs^Fp       , Gs^Fp       , Gs^Fp       , Gs^Fp       , Gs^Fms      , Gs^Fms      , Gs^Fms      , Gs^Fms      , Gg          , Gs^Fp       , Gg          , Gs^Fp       , Gg          , Gs^Fp       , Gs^Fp       , Gs^Fp       , Gs^Fp       
