border_size=1
usage=map

Hh          , Hh          , Hh          , Hh          , Hh          , Hh          , Hh          , Hh          , Gg          , Gg          , Gg          , Gg          , Gg          , Gg          , Gg          , Gg          , Gg          , Gg          , Gg          , Gg          , Rd          , Gg          , Gg          , Ww          , Ww          , Ww          , Wo          , Wo          
Gg          , Hh          , Ce          , Ce          , Ce          , Hh          , Hh          , Gg          , Gs^Fp       , Gs^Fp       , Gg          , Gg          , Dd          , Dd          , Dd          , Gg          , Gs^Fp       , Gg          , Gg          , Gg          , Rd          , Gg          , Gg          , Ww          , Ww          , Ww          , Wo          , Wo          
Gg          , Gg          , Ce          , 2 Ke        , Ce          , Ss          , Gg          , Gg          , Gg          , Gg          , Ds          , Gg          , Gg          , Dd          , Gg          , Gg          , Gs^Fp       , Gs^Fp       , Gg          , Gg          , Gg          , Gg          , Gg          , Ww          , Ww          , Ww          , Wo          , Wo          
Ww          , Gg          , Gg          , Ce          , Ss          , Ss          , Gg          , Gg          , Gg          , Ds          , Dd^Vdt      , Ds          , Gg          , Gg          , Gg          , Gg          , Gg          , Gg          , Gg          , Rd          , Gg          , Gg          , Ww          , Ww          , Ww          , Ww          , Wo          , Wo          
Ww          , Ss          , Ss          , Ss          , Gg          , Gg          , Gs^Fp       , Gg          , Ds          , Ds          , Ds          , Ds          , Ds          , Ds          , Ds          , Gg          , Gs^Fp       , Gg^Vo       , Gg          , Rd          , Gg          , Gg          , Ww          , Ww          , Wo          , Wo          , Wo          , Wo          
Ss          , Ww          , Ww          , Ss          , Ss          , Gg          , Gs^Fp       , Gg          , Ds          , Ds          , Ds          , Dd^Dc       , Ds          , Ds^Dr       , Ds          , Gg          , Gg          , Gg          , Rd          , Gg          , Gg          , Gg          , Ww          , Ww          , Wo          , Wo          , Wo          , Wo          
Gg          , Ss          , Ww          , Ss          , Ss          , Gg          , Gg          , Gg          , Gg          , Gg          , Gg          , Ds          , Gg          , Ds          , Ds          , Ds          , Gg          , Gg          , Rd          , Gg          , Gg          , Ww          , Ww          , Wo          , Wo          , Wo          , Ww          , Ww          
Gg          , Ss          , Ss          , Ww          , Ww          , Ss          , Gg          , Gg^Vo       , Gg          , Gs^Fp       , Gs^Fp       , Gg          , Gs^Fp       , Gg          , Gg          , Gg          , Gg          , Gg          , Wwf         , Gg          , Wwf         , Ww          , Ww          , Wo          , Wo          , Wo          , Ww          , Ww          
Gg          , Gg          , Gg          , Ss          , Ww          , Ss          , Ss          , Gg          , Gg          , Gs^Fp       , Gg          , Gg          , Gg          , Gg          , Ww          , Ww          , Ww          , Ww          , Ww          , Wwf         , Ww          , Ww          , Wo          , Wo          , Wo          , Ww          , Ww          , Ww          
Ds          , Gg          , Gg          , Ss          , Ss          , Ww          , Ww          , Ss          , Ss          , Gg          , Ss          , Ww          , Ww          , Ww          , Ww          , Ww          , Wo          , Ww          , Wo^Bw|      , Wwf         , Wo          , Wo          , Wo          , Wo          , Wo          , Ww          , Ww          , Gg          
Ds          , Ds          , Gg          , Gg          , Gg          , Ss          , Ww          , Ww          , Ww          , Ss          , Ww          , Ww          , Ww          , Ww          , Wo          , Wo          , Wo          , Wo          , Wo^Bw|      , Wo          , Wo          , Wo          , Wo          , Wo          , Ww          , Ww          , Ww          , Gg          
Ds          , Ds          , Ds          , Gg          , Gg          , Ss          , Ss          , Ww          , Ww          , Ww          , Ww          , Ww          , Wo          , Wo          , Wo          , Wo          , Wo          , Wo          , Wo^Bw|      , Wo          , Wo          , Wo          , Ww          , Ww          , Ww          , Ww          , Gg          , Gg          
Ds          , Ds          , Gg          , Gg          , Ww          , Gg          , Ww          , Ww          , Wo          , Ww          , Wo          , Wo          , Wo          , Wo          , Wo          , Wo          , Ww          , Ww          , Wo^Bw|      , Wwf         , Wo          , Ww          , Ww          , Ww          , Ss          , Ss          , Gg          , Gs^Fp       
Ds          , Gg          , Gg          , Gg          , Ww          , Ww          , Ww          , Ww          , Wo          , Wo          , Wo          , Wo          , Ww          , Ww          , Ww          , Ww          , Wwf         , Wwf         , Wwf         , Wwf         , Ww          , Wo          , Ww          , Ss          , Gg          , Gg          , Gs^Fp       , Gs^Fp       
Gg          , Gg          , Ww          , Ww          , Ww          , Ww          , Wo          , Wo          , Wo          , Wo          , Wo          , Wo          , Ww          , Ww          , Ww          , Ww          , Gg          , Gg          , Gg          , Gg          , Ww          , Wo          , Wo          , Ww          , Ss          , Gg          , Gs^Fp       , Gs^Fdf      
Gg          , Gg          , Ww          , Ww          , Wo          , Wo          , Wo          , Wo          , Ww          , Ww          , Ww          , Ww          , Ww          , Ds          , Ds          , Gg          , Rd          , Gg          , Gg^Vc       , Gg          , Ss          , Ww          , Ww          , Ww          , Ss          , Ss^Vhs      , Gs^Fp       , Gs^Fdf      
Ww          , Ww          , Wo          , Wo          , Wo          , Wo          , Ww          , Ww          , Ww          , Ww          , Ww          , Ww          , Ds          , Ds          , Rd          , Gg          , Gg          , Gg          , Gg          , Gg          , Ss          , Ww          , Ww          , Ss          , Gs^Fp       , Gs^Fp       , Gs^Fdf      , Gs^Fdf      
Ww          , Ww          , Wo          , Wo          , Ww          , Ww          , Ww          , Ww          , Ds          , Ds          , Ds          , Ds          , Gg          , Rd          , Gg          , Gg          , Ss          , Gg          , Ss          , Ss          , Ww          , Ww          , Ss          , Ss          , Gs^Fp       , Gs^Fmf      , Gs^Fdf      , Gs^Fdf      
Wo          , Wo          , Wo          , Wo          , Ww          , Ww          , Ds          , Ds          , Co          , Chr         , Chr         , Gg          , Gg          , Gg          , Ss          , Ss          , Ww          , Ss          , Ww          , Ww          , Ss          , Ss          , Gg          , Ss          , Gs^Fp       , Gs^Fp       , Gs^Fdf      , Gs^Fdf      
Wo          , Wo          , Wo          , Ww          , Ww          , Ww          , Ds          , Ds          , Co          , Khr         , Chr         , Gg          , Rd          , Gg          , Ss          , Ww          , Wo          , Ww          , Ss          , Ss          , Gg          , Gg          , Gs^Fp       , Gg          , Gs^Fp       , Gs^Fp       , Gs^Fdf      , Gs^Fdf      
Wo          , Wo          , Ww          , Ww          , Ww          , Ds          , Ds          , Ds          , Gg          , Co          , Gg          , Gg          , Rd          , Gg          , Ss          , Ww          , Ww          , Ww          , Ss          , Gg          , Gs^Fp       , Gs^Fp       , Gs^Fp       , Gs^Fp       , Gg^Ve       , Gs^Fp       , Gs^Fdf      , Gs^Fdf      
Ww          , Ww          , Ww          , Ww          , Ds          , Ds          , Ds          , Gg          , Gs^Fp       , Gg          , Gg          , Gg          , Gg          , Gg          , Gg          , Ss          , Ss          , Ss          , Gg          , Gg          , Gg          , Gg          , Gs^Fp       , Gs^Fp       , Gs^Fp       , Gs^Fp       , Gs^Fmf      , Gs^Fdf      
Ww          , Ww          , Ds          , Ds          , Ds          , Dd^Vdt      , Ds          , Gg          , Gs^Fp       , Gg          , Gs^Fp       , Gg          , Gg          , Gg          , Rd          , Gg          , Gg          , Gg          , Gg          , Gg          , Gg          , Gg          , Gg          , Gg          , Gg          , Gs^Fp       , Gs^Fp       , Gs^Fdf      
Ds          , Ds          , Dd^Dc       , Ds          , Ds          , Ds          , Gg          , Gg          , Gg          , Gs^Fp       , Gs^Fp       , Gs^Fp       , Gg          , Gg          , Gg          , Gg          , Rd          , Rd          , Gg          , Gg          , Gs^Fp       , Gg          , Dd          , Gg          , Gg          , Gs^Fp       , Gs^Fp       , Gs^Fdf      
Ds          , Ds          , Ds          , Dd          , Dd          , Gg          , Gs^Fp       , Gg          , Gs^Fp       , Gs^Fp       , Gs^Fp       , Gg          , Gs^Fp       , Gg          , Gs^Fp       , Gg          , Gg          , Gg          , Gs^Fp       , Gs^Fp       , Gs^Fp       , Gg          , Gg          , Dd          , 1 Gg        , Gs^Fp       , Gs^Fp       , Gs^Fp       
Ds          , Ds          , Gg^Vo       , Ds          , Gg          , Gg          , Gs^Fp       , Gs^Fp       , Gs^Fp       , Gs^Fmf      , Gs^Fmf      , Gs^Fp       , Gs^Fp       , Gs^Fp       , Gs^Fp       , Gs^Fp       , Gs^Fp       , Gs^Fp       , Gs^Fp       , Gs^Fmf      , Gg          , Gs^Fp       , Gs^Fp       , Gg          , Gg          , Gg          , Gs^Fp       , Gs^Fp       
Gg          , Ds          , Gg          , Gg          , Gs^Fp       , Gg          , Gg          , Gg          , Gs^Fp       , Gs^Fp       , Gs^Fp       , Gs^Fp       , Gg          , Gg^Ve       , Gs^Fmf      , Gs^Fp       , Gs^Fp       , Gg          , Gs^Fp       , Gg          , Gg          , Gs^Fp       , Gs^Fp       , Gg          , Gg          , Gg          , Gg          , Gg          
Gg          , Gg          , Gg          , Gs^Fp       , Gs^Fp       , Gg          , Gg          , Gs^Fp       , Gs^Fp       , Gg          , Gg          , Gg          , Gg          , Gs^Fp       , Gs^Fp       , Gs^Fp       , Gg          , Gg          , Gg          , Gg          , Gg          , Gg          , Gg          , Gg          , Gg          , Gg          , Gg          , Gg          
