border_size=1
usage=map

Ss          , Ss          , Ss          , Ss          , Gg          , Gg          , Re          , Re          , Gg          , Gs^Fmf      , Gs^Fmf      , Gg          , Gg          , Ss          , Ss          , Ss          , Ss          , Ww          , Ww          , Ww          , Ss          , Ss          , Ss          , Ss          , Ss          , Ss          , Ss          , Ss          , Ss          , Ss          , Ss          , Ss          , Ss          , Ss          , Ss          , Ss          
Ss          , Ss          , Gg          , Gg          , Re          , Re          , Gg          , Gg          , Ss          , Gg          , Gg          , Gg          , Gg          , Ss          , Gg          , Ss          , Gg          , Ss          , Ww          , Ww          , Ww          , Ss          , Ss          , Ss          , Ss^Vm       , Ss          , Ss          , Ss          , Ss          , Ss          , Ss          , Ss          , Chs         , Ss          , Ss          , Ss          
Ss          , Ss          , Gg          , Re          , Gg          , Gg          , Ce          , Gg          , Gg          , Ss          , Gg          , Gg^Vo       , Gg          , Gg          , Gs^Fdf      , Gg          , Gg          , Ss          , Ss          , Ww          , Wwf         , Gs          , Ss          , Ss          , Ss          , Ss          , Ss          , Ss          , Ss          , Ss          , Ss          , Chs         , 2 Khs       , Chs         , Ss          , Ss          
Gg          , Gg          , Gg          , Re          , Gg          , Ce          , 3 Ke        , Ce          , Gg          , Gg          , Gg          , Gg          , Gg          , Gg          , Gs^Fmf      , Gs^Fmf      , Gg          , Gg          , Ss          , Wwf         , Wwf         , Ss          , Ss          , Ss          , Ss          , Ss          , Ss          , Ss          , Ss          , Ss          , Ss          , Chs         , Chs         , Chs         , Ss          , Ss          
Gg          , Gg^Vo       , Gg          , Re          , Gg          , Ce          , Ce          , Ce          , Gg          , Gs^Fmf      , Gs^Fmf      , Gs^Fmf      , Gs^Fmf      , Gg          , Gg          , Gg          , Gg          , Ss          , Ss          , Ss          , Ww          , Ww          , Ss          , Ss          , Ss          , Gs          , Gs          , Ss          , Ss          , Ss          , Ss          , Ss          , Ss          , Ss          , Ss          , Gg          
Gg          , Gg          , Gg          , Re          , Gg          , Gg          , Gg          , Gg          , Ss          , Gg          , Gs^Fmf      , Gs^Fdf      , Gs^Fmf      , Gg          , Gg          , Gg          , Ss          , Gg          , Ss          , Ss          , Ss          , Ww          , Wwf         , Ss          , Ss          , Gs          , Ss          , Ss          , Ss          , Ss          , Ss          , Ss          , Ss          , Ss^Vhs      , Ss          , Ss          
Gg          , Gg          , Gg          , Re          , Gg          , Gg          , Gg          , Ss          , Gg          , Gg          , Gg          , Gg          , Gg          , Gg          , Gg          , Ss          , Ss          , Ss          , Ss          , Ss          , Ss          , Wwf         , Wwf         , Ss          , Ss          , Ss          , Ss          , Ss          , Ss          , Ss          , Ss          , Ss          , Ss          , Ss          , Ss          , Ss          
Gg          , Gg          , Gg          , Re          , Gg          , Gg^Vo       , Gg          , Gg          , Gs^Fmf      , Gg          , Gs^Fmf      , Gg          , Gg          , Gg          , Gg          , Gg          , Ss          , Ss          , Ss          , Ss          , Ss          , Ss          , Wwf         , Ww          , Ss          , Ss          , Ss          , Ss          , Ss^Vhs      , Ss          , Ss          , Ss          , Ss          , Ss          , Ss          , Ss          
Ss          , Ss          , Gg          , Re          , Gg          , Gg          , Gg          , Gs^Fmf      , Gs^Fmf      , Gs^Fmf      , Gs^Fmf      , Gg          , Gg          , Ss          , Ss          , Ss          , Ss          , Ss^Vm       , Ss          , Ss          , Ss          , Ss          , Ss          , Ww          , Ww          , Ss          , Ss          , Ss          , Ss          , Ss          , Ss          , Ss          , Ss          , Ss          , Gs^Fmf      , Gs^Fmf      
Ww          , Ww          , Ww          , Re          , Ww          , Gg          , Gg          , Gg          , Gg          , Gs^Fmf      , Gg          , Gg          , Ss          , Gg          , Ss          , Ss          , Ss          , Ss          , Ss          , Ss          , Ss          , Ss          , Ss          , Ww          , Ww          , Ss          , Ss          , Ss          , Ss          , Ss          , Ss          , Ss          , Gs^Fmf      , Gs^Fmf      , Gs^Fmf      , Gs^Fmf      
Ss          , Ss          , Gg          , Ww^Bw|      , Gg          , Wwf         , Wwf         , Wwf         , Wwf         , Gg          , Ww          , Ss          , Ww          , Ss          , Ww          , Ss          , Ss          , Ss          , Ss          , Ss          , Ww          , Ww          , Ww          , Ww          , Ss          , Ww          , Ww          , Ss          , Ss          , Ss          , Ss          , Ss          , Ss          , Ss          , Ss          , Ss          
Gg          , Gg          , Gg          , Re          , Gg          , Gs          , Gs          , Gs          , Ss          , Ww          , Ss          , Ww          , Ww          , Ww          , Ww          , Ww          , Ww          , Ww          , Ww          , Ss          , Ww          , Ww          , Ww          , Ss          , Ss          , Ww          , Ww          , Ss          , Ss          , Ss          , Ss          , Ss          , Ss          , Ss          , Ss          , Ss          
Gg          , Gg          , Gg          , Re          , Gg          , Ss          , Gs          , Ss^Vhs      , Gs          , Ss          , Ss          , Ss          , Ss          , Ss          , Ss          , Ss          , Ss          , Ww          , Ss          , Ww          , Ss          , Ss          , Ss          , Ss          , Ss          , Ww          , Ss          , Ww          , Ww          , Ww          , Ww          , Ss          , Ww          , Ss          , Ss          , Ss          
Gg          , Gg          , Gg          , Re          , Gg          , Gg          , Gs          , Gg          , Gg          , Ss          , Ss          , Ss          , Ss          , Ss          , Ss          , Ss          , Ss          , Ss          , Ss          , Ss          , Ss          , Ss^Vm       , Ss          , Ss          , Ss          , Ss          , Ss          , Ww          , Ww          , Ww          , Ww          , Ww          , Ww          , Ww          , Ss          , Ss          
Gg          , Gg          , Re          , Re          , Gg          , Gs          , Ce          , Ce          , Ce          , Gs          , Gs          , Ss          , Gs          , Ss          , Gs          , Ss          , Gs          , Ss          , Gs          , Ss          , Ss          , Ss          , Ss          , Ss          , Ss          , Ss          , Ss          , Ss          , Ss          , Ss          , Ss          , Ss          , Ww          , Ww          , Ww          , Ww          
Re          , Re          , Gg          , Gg          , Ss          , Gs          , Ce          , 4 Ke        , Ce          , Gg          , Gg          , Gg          , Gg          , Gg          , Gg^Vo       , Gg          , Gg          , Gg          , Gg          , Gg          , Gg          , Ss          , Gs          , Ss          , Ss          , Ss          , Ss          , Ss^Vm       , Ss          , Ss          , Ss          , Ss          , Ss          , Ww          , Ww          , Ww          
Gg          , Gg          , Gg          , Ss          , Ss          , Gs          , Gg          , Ce          , Gg          , Gg          , Gg          , Gg          , Gg          , Gg          , Gg          , Gg          , Gg          , Gs^Fmf      , Gs^Fmf      , Gg          , Gg          , Gg          , Gg          , Gg          , Gg          , Gs          , Gs          , Ss          , Ss          , Ss          , Ce          , Ce          , Ce          , Ss          , Gs          , Ss          
Gg          , Gg          , Gs^Fmf      , Gg          , Gg          , Gg          , Gg          , Gg          , Gg          , Gg          , Gs^Fmf      , Gg          , Gs^Fp       , Gs^Fmf      , Gs^Fmf      , Gs^Fmf      , Hh^Fp       , Hh^Fp       , Gs^Fmf      , Gg          , Gs^Fmf      , Gg          , Gg          , Gg          , Gg          , Gg          , Gg          , Ss          , Gs          , Ss          , Ce          , 1 Ke        , Ce          , Gg          , Gg          , Gg          
Gs^Fmf      , Gs^Fmf      , Gs^Fp       , Gg^Vo       , Gs^Fmf      , Gg          , Gg          , Gs^Fmf      , Gs^Fmf      , Gs^Fmf      , Hh^Fmw      , Gs^Fmf      , Gs^Fmf      , Gs^Fmf      , Gs^Fp       , Hh^Fp       , Gs^Fmf      , Gs^Fmf      , Hh          , Gs^Fmf      , Hh          , Gs^Fmf      , Hh          , Gg          , Gs^Fmf      , Gg          , Gg          , Gs          , Gg          , Ss          , Ss          , Ce          , Ss          , Gg          , Ss          , Gg          
Gs^Fmf      , Gs^Fmf      , Gs^Fmf      , Gs^Fmf      , Gg          , Gg          , Gg          , Gg          , Gg          , Gs^Fp       , Gs^Fp       , Gs^Fp       , Gs^Fmf      , Gg          , Gg          , Hh^Fp       , Gs^Fmf      , Hh          , Mm          , Hh          , Mm          , Hh          , Mm          , Hh^Vhh      , Hh          , Gs^Fmf      , Gg          , Gg          , Gg          , Gg          , Gg          , Ss          , Gg          , Ss          , Ss          , Gg          
Gg          , Gs^Fmf      , Gg          , Gg          , Ds          , Gg          , Ds          , Gg          , Gg          , Gg          , Gg          , Gg^Vo       , Gg          , Gg          , Gg          , Gs^Fmf      , Hh          , Hh          , Mm          , Mm          , Hh          , Hh          , Hh          , Mm          , Hh          , Gs^Fmf      , Gs          , Gs          , Ss          , Gg          , Ss          , Gg          , Gg          , Gg          , Gg          , Ss          
Gg          , Gg          , Ds          , Ds          , Ds          , Ds          , Ds          , Ds          , Ds          , Gg          , Gg          , Gg          , Gg          , Gg          , Gg          , Gg          , Hh          , Mm          , Mm          , Hh          , Ggf         , Ggf         , Hh          , Mm          , Hh          , Hh          , Gs          , Gs          , Gs          , Ss          , Gg          , Ss          , Gg          , Ss          , Gg          , Gg          
