border_size=1
usage=map

Ms          , Ms          , Ms          , Ms          , Ai          , Ai          , Aa          , Aa          , Aa          , Aa          , Aa          , Aa          , Aa          , Aa^Fpa      , Aa^Fpa      , Aa^Fpa      , Rr          , Rr          , Rr          , Aa^Fpa      , Ha^Fpa      , Ms          
Ms          , Ms          , Ha          , Ch          , Ai          , Ch          , Aa          , Ch          , Aa          , Ch          , Rr          , Ch          , Rr          , Ch          , Rr          , Rr          , Rr          , Rr          , Rr          , Rr          , Aa^Fpa      , Ms          
Ms          , Ha          , Aa          , Aa          , Ai          , Ai          , Aa          , Aa          , Aa          , Rr          , Rr          , Rr          , Rr          , Rr          , Rr          , Rr          , Rr          , Rr          , Rr          , Aa          , Ha          , Ms          
Ha          , Ha          , Aa          , Ch          , Ai          , Ai          , Aa          , Aa          , Rr          , Ch          , Rr          , Rr          , Rr          , Rr          , Ch          , Rr          , Rr          , Rr          , Aa          , Rr          , Ha          , Ms          
Ha^Fpa      , Aa          , Aa          , Ai          , Ai          , Aa          , Aa          , Rr          , Rr          , Rr          , Rr          , Rr          , Rr          , Ch          , 2 Kh        , Ch          , Rr          , Rr          , Aa          , Aa          , Ha          , Ms          
Ha^Fpa      , Aa          , Ai          , Ch          , Aa          , Aa          , Rr          , Rr          , Rr          , 1 Ch        , Rr          , Rr          , Rr          , Ch          , Ch          , Ch          , Rr          , Rr          , Rr          , Ch          , Ha          , Ms          
Aa          , Aa          , Ai          , Ai          , Aa          , Aa          , Aa          , Rr          , Rr          , Rr          , Rr          , Rr          , Rr          , Rr          , Rr          , Rr          , Rr          , Rr          , Aa          , Aa          , Ha          , Ms          
Aa          , Aa          , Ai          , Ch          , Aa          , Aa          , Rr          , Rr          , Rr          , Ch          , Rr          , Rr          , Rr          , Rr          , Rr          , Rr          , Rr          , Rr          , Rr          , Ch          , Ha^Fpa      , Ms          
Ai          , Ai          , Ai          , Ai          , Aa          , Aa          , Rr          , Rr          , Rr          , Rr          , Rr          , Rr          , Rr          , Ch          , Rr          , Ch          , Rr          , Rr          , Aa          , Aa          , Ha          , Ms          
Ai          , Ai          , Aa          , Ch          , Rr          , Rr          , Rr          , Rr          , Rr          , Rr          , Rr          , Rr          , Rr          , Rr          , Rr          , Rr          , Rr          , Rr          , Aa          , Ch          , Ha^Fpa      , Ms          
Aa          , Aa          , Rr          , Rr          , Rr          , Rr          , Aa          , Aa          , Aa          , Aa          , Rr          , Aa          , Aa          , Aa          , Aa          , Aa          , Aa          , Aa          , Aa          , Ha          , Ha          , Ms          
Rr          , Rr          , Rr          , Rr          , Aa          , Aa          , Aa          , Aa          , Aa          , Aa          , Aa          , Aa          , Aa          , Aa          , Aa          , Aa          , Aa          , Aa          , Aa          , Ch          , Aa          , Ms          
