border_size=1
usage=map

Ms          , Ha^Fma      , Gg          , Ha^Fma      , Ms          , Ms          , Ms          , Ha^Fpa      , Ms          , Ai          , Ms          , Ms          , Ms          , Ms          , Ms          , Ms          , Ms          , Ms          , Ms          , Ms          , Ms          , Ms          , Ms          , Ms          , Ms          , Ms          , Ms          , Ms          
Ms          , Ha^Fma      , Gg          , Ha^Fma      , Ha^Fma      , Ms          , Ms          , Ms          , Ai          , Ai          , Ms          , Ms          , Ms          , Ms          , Ms          , Ms          , Ms          , Ms          , Ms          , Ms          , Ms          , Ms          , Ms          , Ms          , Ms          , Ms          , Ms          , Ms          
Hh^Fp       , Hh^Fmw      , Gg          , Gg          , Ch          , Ms          , Ms          , Ms          , Gg          , Ms          , Gs^Fp       , Ms          , Ha          , Ha^Voa      , Ms          , Ms          , Ms          , Ms          , Gg          , Ai          , Ms          , Ms^Vhha     , Ms          , Ha          , Gs^Fmw      , Ms          , Ms          , Ms          
Ms          , Ha^Fda      , Ha^Fpa      , Ch          , 2 Khr       , Ch          , Ha^Fpa      , Gg          , Hh^Fmw      , Aa^Fpa      , Gg          , Ha          , Aa          , Ha          , Ha^Fpa      , Ms          , Mm          , Gg          , Ms          , Mm          , Ms          , Aa          , Ce          , Ha^Fda      , Ha^Fda      , Ms          , Ms          , Ms          
Ms          , Ms          , Ha^Fma      , Chr         , Khr         , Chr         , Hh^Fmw      , Ai          , Aa          , Gg          , Hh^Fmw      , Gg          , Ha^Fpa      , Gg          , Gg          , Ha^Fpa      , Hh^Fmw      , Ai          , Ha^Fpa      , Hh          , Hh          , Ce          , 3 Ke        , Ce          , Gs^Fmw      , Ms          , Ms          , Ms          
Ms          , Ms          , Ms          , Ha^Fpa      , Ha^Fpa      , Ha^Fma      , Gg          , Gg          , Hh^Fmw      , Ha^Fma      , Gs^Fmw      , Ha^Fpa      , Aa          , Hh^Fmw      , Ha^Fpa      , Gg          , Aa          , Ai          , Ai          , Hh^Fmw      , Ha^Fpa      , Ce          , Ce          , Ce          , Mm          , Ha^Fda      , Ms          , Ms          
Mm^Xm       , Ms          , Ms          , Gs^Fp       , Ha^Fpa      , Ai          , Ha^Fma      , Hh^Fmw      , Mm          , Ms          , Ms^Vhha     , Ha^Fma      , Gs^Fdw      , Aa          , Aa          , Ha^Fpa      , Hh^Fmw      , Aa          , Ha^Fpa      , Gg          , Ha^Fda      , Ha^Fpa      , Ha^Fpa      , Ha^Fpa      , Ms          , Ha^Fma      , Ha^Fda      , Aa^Fma      
Mm^Xm       , Mm^Xm       , Mm^Xm       , Ms          , Ms          , Ai          , Ms          , Ms          , Mm^Xm       , Mm          , Ms          , Ms          , Gg          , Ha^Fpa      , Aa          , Ha          , Ha          , Ha^Fpa      , Ms          , Ai          , Ai          , Aa          , Aa          , Ha^Fpa      , Hh          , Ha^Voa      , Ai          , Gg          
Ms          , Ms          , Mm^Xm       , Mm^Xm       , Mm^Xm       , Ms          , Mm^Xm       , Mm^Xm       , Mm^Xm       , Mm^Xm       , Ha          , Gg          , Ms          , Hh^Fmw      , Hh^Fmw      , Aa          , Ms          , Ha^Fpa      , Aa          , Ha^Fpa      , Aa          , Gg          , Gg          , Ha          , Gg          , Ai          , Hh^Fmw      , Ha^Fpa      
Ms          , Ms          , Ms          , Ms          , Ms          , Mm^Xm       , Mm^Xm       , Mm^Xm       , Mm^Xm       , Ha^Fma      , Gs^Fp       , Ai          , Ha^Fpa      , Ha^Fpa      , Ha^Fpa      , Ha^Fpa      , Hh^Fmw      , Ha^Fpa      , Ha^Fpa      , Aa          , Aa          , Ai          , Ai          , Ai          , Ha^Fpa      , Hh^Fmw      , Mm          , Ms          
Ms          , Ms          , Ha^Fpa      , Ha^Vca      , Ha^Fma      , Ms          , Ms          , Mm^Xm       , Mm^Xm       , Mm^Xm       , Ha^Fpa      , Ai          , Ggf         , Ms          , Ha^Fpa      , Ha^Fpa      , Aa^Fpa      , Ha^Fpa      , Aa          , Aa          , Gg          , Ai          , Gg          , Ha          , Ha^Fpa      , Ms          , Ms          , Ms          
Ms          , Ha^Fma      , Ggf         , Ha^Fpa      , Ggf         , Ha^Fma      , Ms          , Mm^Xm       , Mm^Xm       , Ms          , Ha^Fpa      , Ai          , Ai          , Ha^Voa      , Hh^Fp       , Ms          , Aa^Fpa      , Aa          , Ai          , Ai          , Ms          , Ha^Fma      , Ha^Fma      , Gg          , Ha^Fpa      , Ms          , Ms          , Ms          
Ms          , Ha^Fma      , Ggf         , Aa^Fma      , Ha^Fpa      , Ha^Fma      , Ms          , Mm^Xm       , Mm^Xm       , Ms          , Ggf         , Gg          , Ms          , Ms          , Hh^Fp       , Ha^Fpa      , Ms          , Ha^Fpa      , Ai          , Ha^Voa      , Ms          , Ms          , Ha^Fpa      , Gg          , Ai          , Mm          , Mm          , Ms          
Ms          , Ha^Fma      , Aa^Fma      , Aa^Fpa      , Aa          , Ha^Fpa      , Ms          , Mm^Xm       , Mm^Xm       , Ms          , Gs^Fmw      , Gg          , Ha^Fpa      , Ha^Fpa      , Ha^Fpa      , Ms          , Ha          , Ha          , Ai          , Rd          , Ha^Fpa      , Ha^Fpa      , Mm          , Gs^Fp       , Ai          , Hh          , Ha^Fma      , Ms          
Hh^Fp       , Ha^Fpa      , Aa          , Ggf         , Aa          , Ha^Fma      , Ms          , Mm^Xm       , Mm^Xm       , Ms          , Ha^Fpa      , Ai          , Hh^Fmw      , Ms          , Ms          , Ms          , Ha^Fma      , Ai          , Aa          , Aa^Fma      , Ha^Fpa      , Ms          , Ha          , Aa^Fpa      , Gg          , Ha          , Ha^Fma      , Ha^Fma      
Ms          , Hh^Fp       , Aa          , Ggf         , Aa          , Ha^Fpa      , Ms          , Ms          , Ms          , Ms          , Ha^Fpa      , Ai          , Gg          , Ms          , Ha          , Ha^Fma      , Ai          , Ai          , Aa          , Gs^Fp       , Gs^Fp       , Hh          , Ai          , Ai          , Ha^Fda      , Gg          , Gg          , Gg          
Ms          , Ha^Fpa      , Ha^Fpa      , Ggf         , Ha^Fpa      , Ha^Fma      , Ms          , Ms          , Mm^Xm       , Ms^Vhha     , Ms          , Hh^Fp       , Ha^Fpa      , Gg          , Ai          , Ai          , Aa          , Aa^Fma      , Ha          , Aa^Fpa      , Gg          , Gg          , Ha^Fda      , Ha^Fpa      , Ha^Fpa      , Ha^Fpa      , Ha^Fma      , Aa          
Ms          , Ha^Fpa      , Gs^Fp       , Aa^Fpa      , Ha^Fpa      , Ms          , Ms          , Mm^Xm       , Mm^Xm       , Mm^Xm       , Ms          , Ms          , Hh^Fmw      , Aa          , Aa          , Aa^Fma      , Aa^Fdw      , Ha^Fma      , Ha^Fpa      , Ha^Fpa      , Ha^Fpa      , Ha^Fma      , Mm          , Gs^Fdw      , Aa          , Ha^Fda      , Ha^Fma      , Aa          
Ms          , Ha^Fpa      , Aa^Fpa      , Ggf         , Ha^Fpa      , Ms          , Ms          , Mm^Xm       , Mm^Xm       , Mm^Xm       , Mm          , Ha^Fpa      , Ha^Fpa      , Aa          , Gg          , Aa          , Ha^Fpa      , Ha^Fpa      , Ms          , Ms          , Ms          , Ha          , Ha^Voa      , Gs^Fdw      , Gg          , Ha^Fma      , Ha^Fma      , Aa          
Ms          , Ha^Fpa      , Aa^Fma      , Ggf         , Aa^Fpa      , Ha^Fpa      , Ha^Fpa      , Mm^Xm       , Mm^Xm       , Mm^Xm       , Mm          , Hh^Fp       , Gs^Fdw      , Aa          , Ai          , Aa^Fpa      , Ha^Fda      , Ha^Fma      , Ms          , Ms          , Ha          , Ha          , Aa          , Ha          , Gg          , Aa          , Gg          , Gg          
Ms          , Ha^Fpa      , Aa^Fpa      , Aa^Fma      , Ggf         , Aa^Fpa      , Ha^Fpa      , Ms          , Ms          , Ms          , Ha^Fpa      , Hh^Fp       , Gg          , Ai          , Aa^Fpa      , Aa^Fma      , Aa          , Ha          , Ha          , Ha          , Aa          , Aa          , Aa          , Gg          , Gg          , Aa          , Aa          , Gg          
Ms          , Aa^Vla      , Aa^Fma      , Gs^Fp       , Ggf         , Aa          , Gs^Fmw      , Ha^Fpa      , Aa^Fma      , Ha^Fpa      , Aa          , Aa^Fda      , Ai          , Ai          , Gg          , Aa^Fpa      , Gg          , Aa          , Aa          , Aa          , Gg          , Aa          , Gg          , Gg          , Ce          , Gg          , Aa          , Aa          
Ms          , Ha^Fpa      , Ggf         , Aa          , Aa^Fpa      , Gs^Fmw      , Ha^Fpa      , Gg          , Ha^Fpa      , Gg          , Ai          , Gg          , Aa^Fma      , Aa^Fda      , Aa          , Gg          , Aa^Fpa      , Gg          , Ggf         , Ggf         , Gg          , Aa          , Aa          , Ce          , 1 Ke        , Ce          , Gg          , Gg          
Ms          , Ha^Fma      , Ggf         , Ha^Fma      , Aa^Fpa      , Gs^Fp       , Gs^Fp       , Gs^Fp       , Aa^Fpa      , Aa^Fpa      , Gs^Fmw      , Ai          , Ai          , Aa^Vca      , Aa^Fpa      , Aa^Fpa      , Ha^Fma      , Aa          , Aa^Fpa      , Aa          , Aa^Fpa      , Ha^Fma      , Ha^Fpa      , Ce          , Ce          , Ce          , Aa          , Gg          
Ms          , Ha^Fma      , Ha^Fma      , Ha^Fma      , Ha^Fpa      , Ha^Fma      , Ha^Fpa      , Ha^Fma      , Ha^Fma      , Ha^Fma      , Ha^Fma      , Aa^Fpa      , Ai          , Gg          , Aa^Fpa      , Ha^Fma      , Ha^Fma      , Ha^Fma      , Ha^Fma      , Ha^Fma      , Ha^Fma      , Ha^Fma      , Ha^Fma      , Ha^Fma      , Ha^Fma      , Ha^Fma      , Ha^Fma      , Aa          
Ms          , Ms          , Ms          , Ms          , Ms          , Ms          , Ms          , Ms          , Ms          , Ms          , Ha^Fma      , Aa^Fpa      , Ai          , Aa^Fpa      , Ha^Fma      , Ha^Fma      , Ms          , Ms          , Ms          , Ms          , Ms          , Ha^Fma      , Ms          , Ms          , Ms          , Ms          , Ms          , Ha^Fma      
