border_size=1
usage=map

Hh          , Hh          , Hh          , Hh          , Hh          , Hh          , Hh          , Hh          , Gg          , Gg          , Gg          , Gg          , Gg          , Gg          , Gg          , Gg          , Gg          , Gg          , Gs          , Gs          , Rd          , Gs          , Gs          , Ww          , Ww          , Ww          , Wo          , Wo          
Gs          , Hh          , Ce          , Ce          , Ce          , Hh          , Hh          , Gg          , Gs^Fp       , Gs^Fp       , Gg          , Gg          , Dd          , Dd          , Dd          , Gg          , Gs^Fp       , Gg          , Gs          , Gs          , Rd          , Gs          , Gs          , Ww          , Ww          , Ww          , Wo          , Wo          
Gs          , Gs          , Ce          , 2 Ke        , Ce          , Ss          , Gg          , Gg          , Gg          , Gg          , Ds          , Gg          , Gg          , Dd          , Gg          , Gg          , Gs^Fp       , Gs^Fp       , Gs          , Gs          , Gs          , Gs          , Gs          , Ww          , Ww          , Ww          , Wo          , Wo          
Ww          , Gs          , Gs          , Ce          , Ss          , Ss          , Gg          , Gg          , Gg          , Ds          , Dd^Vdt      , Ds          , Gg          , Gg          , Gg          , Gg          , Gg          , Gg          , Gs          , Rd          , Gs          , Gs          , Ww          , Ww          , Ww          , Ww          , Wo          , Wo          
Ww          , Ss          , Ss          , Ss          , Gg          , Gg          , Gs^Fp       , Gg          , Ds          , Ds          , Ds          , Ds          , Ds          , Ds          , Ds          , Gg          , Gs^Fp       , Gg^Vo       , Gs          , Rd          , Gs          , Gs          , Ww          , Ww          , Wo          , Wo          , Wo          , Wo          
Ss          , Ww          , Ww          , Ss          , Ss          , Gg          , Gs^Fp       , Gg          , Ds          , Ds          , Ds          , Dd^Dc       , Ds          , Ds^Dr       , Ds          , Gs          , Gs          , Gs          , Rd          , Gs          , Gs          , Gs          , Ww          , Ww          , Wo          , Wo          , Wo          , Wo          
Gg          , Ss          , Ww          , Ss          , Ss          , Gg          , Gg          , Gg          , Gg          , Gg          , Gg          , Ds          , Gg          , Ds          , Ds          , Ds          , Gs          , Gs          , Rd          , Gs          , Gs          , Ww          , Ww          , Wo          , Wo          , Wo          , Ww          , Ww          
Gs          , Ss          , Ss          , Ww          , Ww          , Ss          , Gs          , Gg^Vo       , Gg          , Gs^Fp       , Gs^Fp       , Gg          , Gs^Fp       , Gs          , Gs          , Gs          , Gs          , Gs          , Wwf         , Gs          , Wwf         , Ww          , Ww          , Wo          , Wo          , Wo          , Ww          , Ww          
Gs          , Gs          , Gs          , Ss          , Ww          , Ss          , Ss          , Gs          , Gs          , Gs^Fp       , Gs          , Gs          , Gs          , Gs          , Ww          , Ww          , Ww          , Ww          , Ww          , Wwf         , Ww          , Ww          , Wo          , Wo          , Wo          , Ww          , Ww          , Ww          
Gs          , Gs          , Gs          , Ss          , Ss          , Ww          , Ww          , Ss          , Ss          , Gs          , Ss          , Ww          , Ww          , Ww          , Ww          , Ww          , Wo          , Ww          , Wo^Bw|      , Wwf         , Wo          , Wo          , Wo          , Wo          , Wo          , Ww          , Ww          , Gs          
Ds          , Ds          , Gs          , Gs          , Gs          , Ss          , Ww          , Ww          , Ww          , Ss          , Ww          , Ww          , Ww          , Ww          , Wo          , Wo          , Wo          , Wo          , Wo^Bw|      , Wo          , Wo          , Wo          , Wo          , Wo          , Ww          , Ww          , Ww          , Gs          
Ds          , Ds          , Ds          , Gs          , Gs          , Ss          , Ss          , Ww          , Ww          , Ww          , Ww          , Ww          , Wo          , Wo          , Wo          , Wo          , Wo          , Wo          , Wo^Bw|      , Wo          , Wo          , Wo          , Ww          , Ww          , Ww          , Ww          , Gs          , Gs          
Ds          , Ds          , Gs          , Gs          , Ww          , Gs          , Ww          , Ww          , Wo          , Ww          , Wo          , Wo          , Wo          , Wo          , Wo          , Wo          , Ww          , Ww          , Wo^Bw|      , Wwf         , Wo          , Ww          , Ww          , Ww          , Ss          , Ss          , Gs          , Gs^Fp       
Ds          , Gs          , Gs          , Gs          , Ww          , Ww          , Ww          , Ww          , Wo          , Wo          , Wo          , Wo          , Ww          , Ww          , Ww          , Ww          , Wwf         , Wwf         , Wwf         , Wwf         , Ww          , Wo          , Ww          , Ss          , Gs          , Gs          , Gs^Fp       , Gs^Fp       
Gs          , Gs          , Ww          , Ww          , Ww          , Ww          , Wo          , Wo          , Wo          , Wo          , Wo          , Wo          , Ww          , Ww          , Ww          , Ww          , Gs          , Gs          , Gs          , Gs          , Wwf         , Wo          , Wo          , Wwf         , Ss          , Gs          , Gs^Fp       , Gs^Fdf      
Gs          , Gs          , Ww          , Ww          , Wo          , Wo          , Wo          , Wo          , Ww          , Ww          , Ww          , Ww          , Ww          , Ds          , Ds          , Gs          , Rd          , Gs          , Gs^Vht      , Gs          , Ss          , Wwf         , Ww          , Wwf         , Ss          , Ss^Vhs      , Gs^Fp       , Gs^Fdf      
Ww          , Ww          , Wo          , Wo          , Wo          , Wo          , Ww          , Ww          , Ww          , Ww          , Ww          , Ww          , Ds          , Ds          , Rd          , Gs          , Gs          , Gs          , Gs          , Gs          , Ss          , Ww          , Ww          , Ss          , Gs^Fp       , Gs^Fp       , Gs^Fdf      , Gs^Fdf      
Ww          , Ww          , Wo          , Wo          , Ww          , Ww          , Ww          , Ww          , Ds          , Ds          , Ds          , Ds          , Gs          , Rd          , Gs          , Gs          , Ss          , Gs          , Ss          , Ss          , Ww          , Ww          , Ss          , Ss          , Gs^Fp       , Gs^Fmf      , Gs^Fdf      , Gs^Fdf      
Wo          , Wo          , Wo          , Wo          , Ww          , Ww          , Ds          , Ds          , Co          , Chr         , Chr         , Gs          , Gs          , Gs          , Ss          , Ss          , Ww          , Ss          , Ww          , Ww          , Ss          , Ss          , Gs          , Ss          , Gs^Fp       , Gs^Fp       , Gs^Fdf      , Gs^Fdf      
Wo          , Wo          , Wo          , Ww          , Ww          , Ww          , Ds          , Ds          , Co          , Khr         , Chr         , Gs          , Rd          , Gs          , Ss          , Ww          , Wo          , Ww          , Ss          , Ss          , Gs          , Gs          , Gs^Fp       , Gs          , Gs^Fp       , Gs^Fp       , Gs^Fdf      , Gs^Fdf      
Wo          , Wo          , Ww          , Ww          , Ww          , Ds          , Ds          , Ds          , Gs          , Co          , Gs          , Gs          , Rd          , Gs          , Ss          , Ww          , Ww          , Ww          , Ss          , Gs          , Gs^Fp       , Gs^Fp       , Gs^Fp       , Gs^Fp       , Gg^Ve       , Gs^Fp       , Gs^Fdf      , Gs^Fdf      
Ww          , Ww          , Ww          , Ww          , Ds          , Ds          , Ds          , Gs          , Gs^Fp       , Gs          , Gs          , Gs          , Gs          , Gs          , Gs          , Ss          , Ss          , Ss          , Gs          , Gs          , Gg          , Gg          , Gs^Fp       , Gs^Fp       , Gs^Fp       , Gs^Fp       , Gs^Fmf      , Gs^Fdf      
Ww          , Ww          , Ds          , Ds          , Ds          , Dd^Vdt      , Ds          , Gs          , Gs^Fp       , Gs          , Gs^Fp       , Gs          , Gs          , Gs          , Rd          , Gs          , Gs          , Gs          , Gs          , Gs          , Gg          , Gg          , Gg          , Gg          , Gg          , Gs^Fp       , Gs^Fp       , Gs^Fdf      
Ds          , Ds          , Dd^Dc       , Ds          , Ds          , Ds          , Gs          , Gs          , Gs          , Gs^Fp       , Gs^Fp       , Gs^Fp       , Gs          , Gs          , Gs          , Gs          , Rd          , Rd          , Gs          , Gg          , Gs^Fp       , Gg          , Dd          , Gg          , Gg          , Gs^Fp       , Gs^Fp       , Gs^Fdf      
Ds          , Ds          , Ds          , Dd          , Dd          , Gs          , Gs^Fp       , Gs          , Gs^Fp       , Gs^Fp       , Gs^Fp       , Gs          , Gs^Fp       , Gs          , Gs^Fp       , Gs          , Gs          , Gs          , Gs^Fp       , Gs^Fp       , Gs^Fp       , Gg          , Gg          , Dd          , 1 Gg        , Gs^Fp       , Gs^Fp       , Gs^Fp       
Ds          , Ds          , Dd^Vdt      , Ds          , Gs          , Gs          , Gs^Fp       , Gs^Fp       , Gs^Fp       , Gs^Fmf      , Gs^Fmf      , Gs^Fp       , Gs^Fp       , Gs^Fp       , Gs^Fp       , Gs^Fp       , Gs^Fp       , Gs^Fp       , Gs^Fp       , Gs^Fmf      , Gs          , Gs^Fp       , Gs^Fp       , Gg          , Gg          , Gg          , Gs^Fp       , Gs^Fp       
Gs          , Ds          , Gs          , Gs          , Gs^Fp       , Gs          , Gs          , Gs          , Gs^Fp       , Gs^Fp       , Gs^Fp       , Gs^Fp       , Gg          , Gg^Ve       , Gs^Fmf      , Gs^Fp       , Gs^Fp       , Gs          , Gs^Fp       , Gs          , Gs          , Gs^Fp       , Gs^Fp       , Gg          , Gg          , Gg          , Gg          , Gg          
Gs          , Gs          , Gs          , Gs^Fp       , Gs^Fp       , Gs          , Gs          , Gs^Fp       , Gs^Fp       , Gg          , Gg          , Gg          , Gg          , Gs^Fp       , Gs^Fp       , Gs^Fp       , Gs          , Gs          , Gs          , Gs          , Gs          , Gs          , Gs          , Gg          , Gg          , Gg          , Gg          , Gg          
