border_size=1
usage=map

Ms          , Ms          , Ms          , Ai          , Ms          , Ms          , Ms          , Ms          , Ms          , Ha          , Ms          , Ms          , Ms          , Ms          , Ms          , Ms          , Ai          , Ai          , Ai          , Ai          , Ai          , Ai          , Ai          , Ai          , Wwf         , Ww          , Wwf         , Wwr         , Wwr         , Wwr         , Wwr         , Wwr         , Wo          , Wo          , Wo          
Ha          , Ms          , Ha          , Ha          , Ha          , Ms          , Ms          , Ms          , Ai          , Ha          , Ai          , Ai          , Ai          , Ms          , Ms          , Ai          , Ai          , Wwf         , Ww^Vm       , Wwf         , Ai          , Wwf         , Wwf         , Wwf         , Chw         , Chw         , Chw         , Wwf         , Wwf         , Ww          , Ww          , Ww          , Ww          , Ww          , Qxu         
Ms          , Ha          , Aa          , Aa          , Aa          , Ms          , Ai          , Ai          , Ww          , Ai          , Wo          , Wo          , Wwf         , Ms          , Ms          , Ai          , Wwf         , Wwf         , Wwf         , Wwf         , Ai          , Ai          , Wwf         , Wwf         , Chw         , 2 Khw       , Chw         , Wwf         , Wwf         , Wwf         , Qxu         , Qxu         , Qxu         , Qxu         , Qlf         
Ha          , Ha          , Aa          , Uu          , Uu          , Ai          , Ai          , Ww          , Ww          , Wo          , Wwf         , Wwf         , Wwf         , Ai          , Xu          , Xu          , Xu          , Xu          , Xu          , Xu          , Xu          , Wwf         , Xu          , Wwf         , Wwf         , Chw         , Ww          , Ww          , Ww          , Qxu         , Qlf         , Qlf         , Qlf         , Qlf         , Qlf         
Aa          , Aa          , Ai          , Uu          , Ai          , Ai          , Wwf         , Wwf         , Wwf         , Wwf         , Xu          , Xu          , Xu          , Xu          , Wwf         , Wwf         , Wwf         , Wwf         , Wwf         , Wwf         , Wwf         , Xu          , Wwf         , Wwf         , Xu          , Wwf         , Ww          , Ww^Vm       , Ww          , Qxu         , Qlf         , Qlf         , Qlf         , Qlf         , Qlf         
Ai          , Ai          , Wwf         , Ai          , Wwf         , Wwf         , Xu          , Wwf         , Xu          , Xu          , Wwf         , Wwf         , Wwf         , Wwf         , Gs^Fdf      , Ss          , Gs^Fdf      , Gs^Fmf      , Gs^Fmf      , Ss          , Ss          , Wwf         , Wwf         , Wwf         , Wwf         , Xu          , Wwf         , Ww          , Qxu         , Qxu         , Qlf         , Qlf         , Qlf         , Qlf         , Qlf         
Wwf         , Wwf         , Wwf         , Wwf         , Xu          , Xu          , Wwf         , Xu          , Wwf         , Wwf         , Wwf         , Wwf         , Gs^Fdf      , Ss          , Gs^Fdf      , Gs^Fdf      , Gg^Ve       , Gs^Fdf      , Gs^Fmf      , Gs^Fmf      , Ww          , Wwf         , Xu          , Wwf         , Ww          , Xu          , Wwf         , Wwf         , Qxu         , Qlf         , Qlf         , Qlf         , Qlf         , Qlf         , Qlf         
Wwf         , Wwf         , Xu          , Xu          , Wwf         , Wwf         , Wwf         , Wwf         , Wwf         , Wwf         , Ww          , Ss          , Gs^Fdf      , Gs^Fmf      , Gs^Fmf      , Gs^Fdf      , Gs^Fdf      , Gs^Fdf      , Ww          , Ww          , Wwr         , Ww          , Xu          , Ww          , Ww^Vm       , Ww          , Wwf         , Wwf         , Qxu         , Qlf         , Qlf         , Qlf         , Qlf         , Qlf         , Qlf         
Xu          , Xu          , Wwf         , Wwf         , Chw         , Wwf         , Chw         , Wwf         , Ww          , Ww          , Wo          , Ww          , Ww          , Gs^Fmf      , Ww          , Ww          , Ww          , Gs^Fmf      , Ww          , Wo          , Wwr         , Xu          , Wwf         , Ww          , Ww          , Ww          , Wwf         , Qxu         , Qlf         , Qlf         , Qlf         , Qlf         , Qlf         , Qlf         , Qxu         
Xu          , Wwf         , Ww^Vm       , Wwf         , 4 Khw       , Wwf         , Wwf         , Ww          , Wo          , Wo          , Ww          , Wo          , Wo          , Ww          , Wo          , Wo          , Wo          , Ww          , Wo          , Wo          , Ww          , Wwr         , Xu          , Wwf         , Xu          , Wwf         , Xu          , Qxu         , Qxu         , Qlf         , Qxu         , Qlf         , Qxu         , Qxu         , Uu          
Xu          , Wwf         , Wwf         , Wwf         , Chw         , Chw         , Chw         , Ww          , Ww          , Ww          , Xu          , Ww          , Ww          , Wo          , Ww          , Wo          , Ww          , Wo          , Ww          , Ww          , Xu          , Ww          , Re          , Xu          , Uu          , Xu          , Uu          , Xu          , Xu          , Qxu         , Qxu         , Qxu         , Uu          , Uu          , Uu          
Xu          , Xu          , Xu          , Wwf         , Wwf         , Wwf         , Wwf         , Wwf         , Wwf         , Xu          , Xu          , Ww          , Ww          , Ww          , Ww          , Ww          , Ww          , Ww          , Xu          , Xu          , Re          , Re          , Ur          , Uu          , Uu^Uf       , Uu          , Uu          , Uu          , Uu          , Xu          , Xu          , Qxu         , Uu          , Uu^Vu       , Ur          
Xu          , Xu          , Xu          , Xu          , Wwf         , Xu          , Xu          , Wwf         , Wwf         , Gs^Fdf      , Wwf         , Xu          , Xu          , Xu          , Xu          , Xu          , Xu          , Ww          , Xu          , Uu          , Uu          , Ur          , Uu          , Uu          , Uu          , Uu          , Uu          , Uu^Vud      , Uu          , Uh          , Uh          , Qxu         , Qxu^Bs/     , Ur          , Uu          
Xu          , Xu          , Xu          , Xu          , Wwf         , Xu          , Xu          , Xu          , Xu          , Wwf         , Wwf         , Wwf         , Wwf         , Xu          , Wwf         , Xu          , Wwf         , Xu          , Xu          , Uh          , Uu          , Uu^Vud      , Uu          , Uu          , Cud         , Cud         , Cud         , Uu          , Uu          , Uu          , Ur          , Ur          , Qxu         , Uu          , Uu          
Xu          , Xu          , Wwf         , Wwf         , Ww          , Wwf         , Wwf         , Xu          , Xu          , Xu          , Wwf         , Wo          , Wo          , Wwf         , Ww^Vm       , Wwf         , Wwf         , Wwf         , Xu          , Xu          , Xu          , Uu          , Ur          , Uu          , Cud         , 5 Kud       , Cud         , Uh          , Uu          , Uu          , Ur          , Uu          , Uu          , Qxu         , Uu          
Xu          , Xu          , Wwf         , Ww          , Ww^Vm       , Ww          , Wwf         , Gs^Fdf      , Wwf         , Xu          , Wwf         , Wo          , Wo          , Wo          , Wo          , Wo          , Wwf         , Wwf         , Wwf         , Xu          , Uu          , Uu          , Uu^Vud      , Uu          , Uu          , Cud         , Uh          , Uu          , Cud         , Uu          , Uu          , Ur          , Ur          , Qxu         , Uu          
Xu          , Xu          , Wwf         , Ww          , Ww          , Ww          , Wwf         , Wwf         , Wwf         , Wwf         , Wwf         , Ss          , Wwf         , Wwf         , Wwf         , Wwf         , Gs^Fdf      , Wwf         , Wwf         , Xu          , Uu          , Uu          , Uu          , Uu          , Uu^Uf       , Uu          , Uu          , Uu          , Uu          , Uu          , Uu          , Uu          , Qxu         , Qxu^Bs\     , Ur          
Xu          , Xu          , Xu          , Wwf         , Wwf         , Gs^Fdf      , Xu          , Xu          , Xu          , Wwf         , Wwf         , Wwf         , Wwf         , Gs^Fdf      , Ss          , Gs^Fdf      , Wwf         , Wwf         , Wwf         , Xu          , Re          , Re          , Re          , Uu          , Xu          , Uu          , Xu          , Uu          , Xu          , Uu          , Xu          , Qxu         , Qxu         , Qxu         , Uu          
Xu          , Xu          , Xu          , Xu          , Wwf         , Xu          , Xu          , Xu          , Wo          , Ww          , Xu          , Wwf         , Wwf         , Ss          , Gs^Fdf      , Ss          , Wwf         , Wwf         , Xu          , Re          , Xu          , Xu          , Xu          , Xu          , Uu          , Xu          , Uu^Vud      , Xu          , Ur          , Xu          , Ur          , Xu          , Xu          , Qxu         , Qxu         
Wwf         , Xu          , Wwf         , Xu          , Wwf         , Xu          , Wo          , Wo          , Wo          , Wo          , Xu          , Gs^Fdf      , Wwf         , Wwf         , Wwf         , Gs^Fdf      , Wwf         , Wwf         , Xu          , Xu          , Re          , Uu          , Uu          , Re          , Xu          , Uu          , Xu          , Re          , Xu          , Uu^Vud      , Xu          , Uu          , Uu          , Xu          , Xu          
Wwf         , Wwf         , Wwf         , Wwf         , Wo          , Wo          , Wo          , Wo          , Xu          , Xu          , Wwf         , Wwf         , Wwf         , Wwf         , Xu          , Wwf         , Xu          , Xu          , Re          , Re          , Re          , Xu          , Xu          , Xu          , Ai          , Xu          , Aa          , Xu          , Aa          , Xu          , Uh          , Xu          , Xu          , Xu          , Xu          
Wwf         , Ww^Vm       , Wwf         , Wo          , Ww          , Wo          , Wo          , Xu          , Ww          , Wwf         , Ww^Vm       , Wwf         , Gs^Fdf      , Xu          , Ww^Vm       , Xu          , Xu          , Xu          , Xu          , Xu          , Xu          , Re          , Wwf         , Ai          , Ai          , Ai          , Aa          , Aa          , Aa          , Aa          , Aa          , Uu          , Ha          , Xu          , Xu          
Wwf         , Wwf         , Ww          , Ww          , Chw         , Ww          , Ww          , Xu          , Ww          , Wwf         , Wwf         , Wwf         , Wwf         , Xu          , Xu          , Wwf         , Wwf         , Wwf         , Wwf         , Wwf         , Wwf         , Xu          , Xu          , Wwf         , Wwf         , Wwf         , Uu          , Uu^Ufi      , Aa          , Aa          , Aa          , Aa          , Ha          , Ms          , Ms          
Xu          , Xu          , Ww          , Chw         , 3 Khw       , Chw         , Ww          , Xu          , Xu          , Xu          , Xu          , Wwf         , Wwf         , Gs^Fdf      , Wwf         , Xu          , Xu          , Xu          , Xu          , Xu          , Xu          , Wwf         , Wwf         , Wwf         , Uu          , Wwf         , Uu          , Uu          , Ce          , Aa          , Aa          , Uu          , Ms          , Ms          , Ms          
Xu          , Xu          , Ww          , Chw         , Chw         , Chw         , Ww          , Xu          , Uu          , Uu^Vud      , Uu          , Xu          , Wwf         , Wwf         , Wwf         , Wwf         , Wwf         , Wwf         , Wwf         , Wwf         , Wwf         , Wwf         , Uu          , Uu          , Uu^Vud      , Uu          , Re          , Ce          , 1 Ke        , Ce          , Aa          , Uu          , Ha          , Ms          , Ms          
Xu          , Ww          , Chw         , Ww          , Ww          , Ww          , Xu          , Xu          , Re          , Ql          , Xu          , Xu          , Xu          , Xu          , Xu          , Xu          , Xu          , Xu          , Xu          , Xu          , Xu          , Xu          , Xu          , Uu          , Uu          , Uu          , Re          , Ce          , Ce          , Ce          , Aa          , Uu          , Ha          , Ms          , Ms          
Xu          , Ww          , Ww          , Ww          , Xu          , Xu          , Re          , Uu          , Ql          , Ql^Bs\      , Re          , Uu          , Uu          , Uu          , Uu          , Uu          , Uu          , Re          , Re          , Uu          , Uu          , Re          , Re          , Re          , Uu          , Uu          , Re          , Re          , Re          , Aa          , Aa          , Aa          , Ha          , Ms          , Ms          
Xu          , Xu          , Xu          , Xu          , Uu          , Re          , Xu          , Xu          , Ql          , Xu          , Xu          , Xu          , Xu          , Xu          , Xu          , Xu          , Xu          , Xu          , Xu          , Xu          , Xu          , Xu          , Xu          , Uu          , Xu          , Aa          , Aa          , Re          , Aa          , Aa          , Uu^Vud      , Aa          , Ms          , Ms          , Ms          
Ql          , Ql          , Ql          , Qxu         , Xu          , Xu          , Xu          , Xu          , Ql          , Ql          , Ql          , Xu          , Xu          , Xu          , Xu          , Xu          , Xu          , Xu          , Xu          , Xu          , Xu          , Xu          , Xu          , Xu          , Xu          , Xu          , Xu          , Aa          , Aa          , Uu          , Uu          , Aa          , Ha          , Ms          , Ms          
