border_size=1
usage=map

Ms          , Ms          , Ms          , Ai          , Ms          , Ms          , Ms          , Ms          , Ms          , Ha          , Ms          , Ms          , Ms          , Ms          , Ms          , Ms          , Ai          , Ai          , Ai          , Ai          , Ai          , Ai          , Ai          , Ai          , Wwf         , Ww          , Wwf         , Wwr         , Wwr         , Wwr         , Wwr         , Wwr         , Wo          , Wo          , Wo          
Ha          , Ms          , Ha          , Ha          , Ha          , Ms          , Ms          , Ms          , Ai          , Ha          , Ai          , Ai          , Ai          , Ms          , Ms          , Ai          , Ai          , Wwf         , Ww^Vm       , Wwf         , Ai          , Wwf         , Wwf         , Wwf         , Chw         , Chw         , Chw         , Wwf         , Wwf         , Ww          , Ww          , Ww          , Ww          , Ww          , Qxu         
Ms          , Ha          , Aa          , Aa          , Aa          , Ms          , Ai          , Ai          , Ww          , Ai          , Wo          , Wo          , Wwf         , Ms          , Ms          , Ai          , Wwf         , Wwf         , Wwf         , Wwf         , Ai          , Ai          , Wwf         , Wwf         , Chw         , 2 Khw       , Chw         , Wwf         , Wwf         , Wwf         , Qxu         , Qxu         , Qxu         , Qxu         , Qlf         
Ha          , Ha          , Aa          , Uu          , Uu          , Ai          , Ai          , Ww          , Ww          , Wo          , Wwf         , Wwf         , Wwf         , Ai          , Xu          , Xu          , Xu          , Xu          , Xu          , Xu          , Xu          , Wwf         , Xu          , Wwf         , Wwf         , Chw         , Ww          , Ww          , Ww          , Qxu         , Qlf         , Qlf         , Qlf         , Qlf         , Qlf         
Aa          , Aa          , Ai          , Uu          , Ai          , Ai          , Wwf         , Wwf         , Wwf         , Wwf         , Xu          , Xu          , Xu          , Xu          , Wwf         , Wwf         , Wwf         , Wwf         , Wwf         , Wwf         , Wwf         , Xu          , Wwf         , Wwf         , Xu          , Wwf         , Ww          , Ww^Vm       , Ww          , Qxu         , Qlf         , Qlf         , Qlf         , Qlf         , Qlf         
Ai          , Ai          , Wwf         , Ai          , Wwf         , Wwf         , Xu          , Wwf         , Xu          , Xu          , Wwf         , Wwf         , Wwf         , Wwf         , Gs^Fdf      , Ss          , Gs^Fdf      , Gs^Fmf      , Gs^Fmf      , Ss          , Ss          , Wwf         , Wwf         , Wwf         , Wwf         , Xu          , Wwf         , Ww          , Qxu         , Qxu         , Qlf         , Qlf         , Qlf         , Qlf         , Qlf         
Wwf         , Wwf         , Wwf         , Wwf         , Xu          , Xu          , Gs^Fdf      , Xu          , Gs^Fdf      , Gs^Fdf      , Wwf         , Wwf         , Gs^Fdf      , Ss          , Gs^Fdf      , Gs^Fdf      , Gg^Ve       , Gs^Fdf      , Gs^Fmf      , Gs^Fmf      , Ww          , Wwf         , Xu          , Wwf         , Ww          , Xu          , Wwf         , Wwf         , Qxu         , Qlf         , Qlf         , Qlf         , Qlf         , Qlf         , Qlf         
Wwf         , Wwf         , Xu          , Xu          , Wwf         , Wwf         , Wwf         , Wwf         , Wwf         , Wwf         , Ww          , Ss          , Gs^Fdf      , Gs^Fmf      , Gs^Fmf      , Gs^Fdf      , Gs^Fdf      , Gs^Fdf      , Ww          , Ww          , Wwr         , Ww          , Xu          , Ww          , Ww^Vm       , Ww          , Wwf         , Wwf         , Qxu         , Qlf         , Qlf         , Qlf         , Qlf         , Qlf         , Qlf         
Xu          , Xu          , Wwf         , Wwf         , Chw         , Wwf         , Chw         , Wwf         , Ww          , Ww          , Wo          , Ww          , Ww          , Gs^Fmf      , Ww          , Ww          , Ww          , Gs^Fmf      , Ww          , Wo          , Wwr         , Xu          , Wwf         , Ww          , Ww          , Ww          , Wwf         , Qxu         , Qlf         , Qlf         , Qlf         , Qlf         , Qlf         , Qlf         , Qxu         
Xu          , Wwf         , Ww^Vm       , Wwf         , 4 Khw       , Wwf         , Wwf         , Ww          , Wo          , Wo          , Ww          , Wo          , Wo          , Ww          , Wo          , Wo          , Wo          , Ww          , Wo          , Wo          , Wwf         , Wwr         , Xu          , Wwf         , Xu          , Wwf         , Xu          , Qxu         , Qxu         , Qlf         , Qxu         , Qlf         , Qxu         , Qxu         , Uu          
Xu          , Wwf         , Wwf         , Wwf         , Chw         , Chw         , Chw         , Ww          , Ww          , Ww          , Xu          , Ww          , Ww          , Wo          , Ww          , Wo          , Ww          , Wo          , Ww          , Ww          , Ww          , Ww          , Ur          , Xu          , Uu          , Xu          , Uu          , Xu          , Xu          , Qxu         , Qxu         , Qxu         , Uu          , Uu          , Uu          
Xu          , Xu          , Xu          , Wwf         , Wwf         , Wwf         , Wwf         , Wwf         , Wwf         , Xu          , Xu          , Ww          , Ww          , Ww          , Ww          , Ww          , Ww          , Ww          , Xu          , Xu          , Ur          , Ur          , Ur          , Uu          , Uu^Uf       , Uu          , Uu          , Uu          , Uu          , Xu          , Qxu         , Qxu         , Uu          , Uu^Vu       , Ur          
Xu          , Xu          , Xu          , Xu          , Wwf         , Xu          , Xu          , Wwf         , Wwf         , Gs^Fdf      , Gs^Fdf      , Xu          , Xu          , Xu          , Xu          , Xu          , Xu          , Ww          , Xu          , Uu          , Uu          , Ur          , Uu          , Uu          , Uu          , Uu          , Uu          , Uu^Vud      , Uu          , Uh          , Uh          , Qxu         , Qxu^Bs/     , Ur          , Uu          
Xu          , Xu          , Xu          , Xu          , Wwf         , Xu          , Xu          , Xu          , Xu          , Wwf         , Wwf         , Wwf         , Wwf         , Wwf         , Wwf         , Wwf         , Wwf         , Xu          , Xu          , Uh          , Uu          , Uu^Vud      , Uu          , Uu          , Cud         , Cud         , Cud         , Uu          , Uu          , Uu          , Ur          , Ur          , Qxu         , Uu          , Uu          
Xu          , Xu          , Ds          , Gs^Fdf      , Ww          , Wwf         , Wwf         , Xu          , Xu          , Xu          , Wwf         , Wo          , Wo          , Wwf         , Ww          , Wwf         , Ww^Vm       , Wwf         , Wwf         , Xu          , Xu          , Uu          , Ur          , Uu          , Cud         , 5 Kud       , Cud         , Uh          , Uu          , Uu          , Ur          , Uu          , Uu          , Qxu         , Uu          
Xu          , Xu          , Ds          , Ww          , Ww^Vm       , Ww          , Wwf         , Gs^Fdf      , Gs^Fdf      , Xu          , Wwf         , Wo          , Wo          , Ww          , Ww          , Ww          , Wwf         , Wwf         , Wwf         , Xu          , Uu          , Uu          , Uu^Vud      , Uu          , Uu          , Cud         , Uh          , Uu          , Cud         , Uu          , Uu          , Ur          , Ur          , Qxu         , Uu          
Xu          , Xu          , Wwf         , Ww          , Ww          , Ww          , Wwf         , Wwf         , Wwf         , Wwf         , Wwf         , Ss^Vhs      , Wwf         , Ww          , Xu          , Wwf         , Wwf         , Wwf         , Wwf         , Xu          , Uu          , Uu          , Uu          , Uu          , Uu          , Uu          , Uu          , Uu          , Uu          , Uu          , Ur          , Ur          , Uh          , Qxu^Bs\     , Ur          
Xu          , Xu          , Xu          , Wwf         , Wwf         , Gs^Fdf      , Xu          , Xu          , Xu          , Wwf         , Wwf         , Wwf         , Ss          , Ss          , Gs^Fdf      , Xu          , Xu          , Ds          , Ds          , Ss          , Ur          , Ur          , Ur          , Uu          , Ur          , Uu^Uf       , Ur          , Uu          , Ur          , Ur          , Uu          , Uu^Vu       , Qxu         , Qxu         , Uu          
Xu          , Xu          , Xu          , Xu          , Wwf         , Xu          , Xu          , Xu          , Wo          , Ww          , Xu          , Wwf         , Wwf         , Gs^Fdf      , Gs^Fdf      , Ss          , Xu          , Ds          , Ds          , Ds          , Xu          , Xu          , Xu          , Ur          , Xu          , Ur          , Xu          , Ur          , Xu          , Uu          , Xu          , Uh          , Xu          , Qxu         , Qxu         
Wwf         , Xu          , Wwf         , Xu          , Wwf         , Xu          , Wo          , Wo          , Wo          , Ww          , Xu          , Gs^Fdf      , Wwf         , Wwf         , Wwf         , Ss          , Xu          , Xu          , Xu          , Xu          , Uu          , Uu          , Re          , Xu          , Re          , Xu          , Re          , Xu          , Uu^Vud      , Xu          , Uu          , Xu          , Re          , Xu          , Xu          
Wwf         , Wwf         , Wwf         , Wwf         , Wo          , Wo          , Wo          , Wo          , Xu          , Xu          , Ds          , Ds          , Wwf         , Wwf         , Xu          , Xu          , Wwf         , Wwf         , Ww^Vm       , Xu          , Uu          , Xu          , Xu          , Re          , Xu          , Uu          , Xu          , Re          , Uu          , Uu          , Uu^Vud      , Uu          , Xu          , Xu          , Xu          
Wwf         , Ww^Vm       , Wwf         , Wo          , Ww          , Wo          , Wo          , Ww          , Xu          , Ds          , Ww^Vm       , Wwf         , Gs^Fdf      , Gs^Fdf      , Xu          , Wwf         , Xu          , Xu          , Xu          , Xu          , Xu          , Re          , Wwf         , Xu          , Ai          , Xu          , Ai          , Xu          , Xu          , Xu          , Xu          , Xu          , Ha          , Xu          , Xu          
Wwf         , Wwf         , Ww          , Ww          , Chw         , Ww          , Ww          , Ww          , Xu          , Ds          , Wwf         , Wwf         , Wwf         , Wwf         , Xu          , Wwf         , Wwf         , Wwf         , Wwf         , Wwf         , Wwf         , Xu          , Xu          , Wwf         , Wwf         , Ai          , Ai          , Ai          , Aa          , Aa          , Aa          , Aa          , Ha          , Ms          , Ms          
Xu          , Xu          , Ww          , Chw         , 3 Khw       , Chw         , Ww          , Ds          , Xu          , Xu          , Xu          , Wwf         , Wwf         , Gs^Fdf      , Wwf         , Xu          , Xu          , Xu          , Xu          , Xu          , Xu          , Wwf         , Wwf         , Wwf         , Wwf         , Ai          , Re          , Ai          , Ce          , Aa          , Aa          , Uu          , Ms          , Ms          , Ms          
Xu          , Xu          , Ww          , Chw         , Chw         , Chw         , Ww          , Xu          , Uu          , Uu^Vud      , Uu          , Xu          , Wwf         , Wwf         , Wwf         , Wwf         , Wwf         , Wwf         , Wwf         , Wwf         , Wwf         , Wwf         , Wwf         , Ds          , Ds          , Re          , Re          , Ce          , 1 Ke        , Ce          , Aa          , Uu          , Ha          , Ms          , Ms          
Xu          , Ww          , Chw         , Ww          , Ww          , Ww          , Xu          , Xu          , Re          , Ql          , Xu          , Xu          , Xu          , Ds          , Xu          , Wwf         , Xu          , Wwf         , Xu          , Wwf         , Ds          , Wwf         , Xu          , Uu          , Uu^Vud      , Uu          , Re          , Ce          , Ce          , Ce          , Aa          , Uu          , Ha          , Ms          , Ms          
Xu          , Ww          , Ww          , Ww          , Xu          , Xu          , Re          , Uu          , Ql          , Ql^Bs\      , Re          , Uu          , Re          , Xu          , Uu^Vud      , Xu          , Uu          , Xu          , Re          , Xu          , Xu          , Xu          , Re          , Re          , Uu          , Uu          , Re          , Re          , Re          , Aa          , Aa          , Aa          , Ha          , Ms          , Ms          
Xu          , Xu          , Xu          , Xu          , Xu          , Re          , Xu          , Xu          , Ql          , Xu          , Xu          , Xu          , Re          , Xu          , Xu          , Uu          , Xu          , Re          , Uu          , Uu          , Uu          , Uu          , Uu          , Uu          , Xu          , Aa          , Aa          , Re          , Aa          , Aa          , Uu^Vud      , Aa          , Ms          , Ms          , Ms          
Xu          , Uu          , Xu          , Xu          , Qxu         , Uu^Ii       , Qxu         , Xu          , Xu          , Ql          , Ql          , Xu          , Xu          , Uu          , Uu          , Xu          , Re          , Xu          , Xu          , Xu          , Xu          , Xu          , Xu          , Xu          , Uu          , Xu          , Re          , Re          , Aa          , Uu          , Uu          , Aa          , Ha          , Ms          , Ms          
Xu          , Uu          , Re          , Xu          , Ql          , Qxu         , Ql          , Ql          , Ql          , Ql          , Ql          , Ql          , Xu          , Uu^Vud      , Uu          , Re          , Uu          , Re          , Uu          , Uu          , Uu^Vud      , Uu          , Uu          , Re          , Re          , Re          , Uu          , Uu          , Xu          , Xu          , Xu          , Aa          , Ha          , Ha          , Ha          
Xu          , Uu          , Xu          , Xu          , Ql          , Ql          , Ql          , Ql          , Ql          , Ql          , Ql          , Ql          , Ql          , Xu          , Xu          , Uu          , Xu          , Uu          , Uu          , Uu          , Uu          , Uu          , Uu          , Uu          , Xu          , Uu          , Xu          , Xu          , Xu          , Xu          , Xu          , Xu          , Xu          , Xu          , Xu          
Ql          , Xu          , Ql          , Ql          , Ql          , Ql          , Ql          , Ql          , Ql          , Ql          , Ql          , Ql          , Ql          , Xu          , Xu          , Xu          , Xu          , Xu          , Xu          , Xu          , Xu          , Xu          , Xu          , Xu          , Xu          , Xu          , Xu          , Xu          , Xu          , Xu          , Xu          , Xu          , Xu          , Xu          , Xu          
