border_size=1
usage=map

Ha^Fpa      , Aa          , Aa          , Aa          , Aa^Fpa      , Ha^Fma      , Ha^Fma      , Ms          , Ai          , Ms          , Ms          , Ha          , Aa          , Aa^Fpa      , Aa          , Aa^Fpa      , Aa^Fpa      , Ha^Fpa      , Aa^Fpa      , Ha^Fpa      , Ha^Fpa      , Ms          , Ha^Fpa      , Ms          , Ms          , Ha          , Ms          , Ha          , Ms          , Ms          
Ha^Fpa      , Ha^Fpa      , Ha^Fpa      , Aa          , Ce          , Aa^Fpa      , Aa^Fpa      , Ha^Fma      , Ai          , Ms          , Ha^Fpa      , Ha^Fpa      , Gg          , Gg          , Gg          , Aa          , Gg          , Aa          , Gg          , Aa^Fpa      , Aa          , Ha^Fpa      , Aa^Voa      , Ha^Fpa      , Ce          , Ce          , Ce          , Ms          , Ha^Fpa      , Ms          
Aa          , Ha^Fpa      , Ha^Fpa      , Ce          , 1 Ke        , Ce          , Aa^Fpa      , Aa^Fpa      , Ai          , Ha^Vca      , Aa^Fpa      , Aa^Fpa      , Gg          , Aa^Fpa      , Ha^Fpa      , Gg          , Ha^Dr       , Aa          , Aa          , Gg          , Gg          , Aa          , Aa          , Ha^Fpa      , Ce          , 5 Ke        , Ce          , Ha^Fpa      , Ha^Fpa      , Ms          
Ha^Fpa      , Ha^Fpa      , Ha^Fpa      , Ce          , Ce          , Ce          , Aa^Fpa      , Ai          , Aa          , Aa^Fpa      , Aa^Fpa      , Aa          , Ha^Fpa      , Ha^Fpa      , Ha^Fpa      , Ha^Fpa      , Gs          , Aa          , Ha^Fpa      , Aa^Fpa      , Aa^Fpa      , Aa          , Aa^Fpa      , Aa          , Gg          , Ce          , Ha^Fpa      , Ha^Fpa      , Ha^Fpa      , Ms          
Ha^Fpa      , Ha^Fpa      , Ms          , Ha^Fpa      , Ha^Fma      , Ha^Fpa      , Ha^Fpa      , Ai          , Ha^Fpa      , Aa          , Gs          , Gs          , Ha^Fpa      , Ms          , Ms          , Ha^Vhha     , Gs          , Ha^Fpa      , Ms          , Ha^Fpa      , Ha^Fpa      , Aa^Fpa      , Aa          , Aa          , Gg          , Gg          , Gg          , Ha^Fpa      , Aa^Voa      , Ms          
Ms          , Ms          , Ms          , Ha^Fpa      , Ms          , Ms          , Ms          , Ha^Fpa      , Ms          , Ha^Fpa      , Ha^Fpa      , Gs          , Ha^Fpa      , Ms          , Ms          , Ha          , Gs          , Ha^Fpa      , Ms          , Ms          , Ms          , Ha^Fpa      , Aa^Fpa      , Aa          , Gg          , Aa          , Aa^Fpa      , Aa          , Ha^Fpa      , Gg          
Ms          , Ms          , Ha^Fpa      , Ms^Vhha     , Ms          , Ms          , Ms          , Ms          , Ms          , Ms          , Ha^Fma      , Ha^Fpa      , Ha^Fma      , Ha^Fma      , Ms          , Ha          , Ms          , Ms          , Mm^Xm       , Mm^Xm       , Ms^Vhha     , Ha^Fpa      , Ha^Fpa      , Aa          , Aa          , Aa          , Aa^Fpa      , Aa^Fpa      , Ha^Fpa      , Gg          
Ha^Fpa      , Ms          , Aa          , Ha^Fma      , Ai          , Ms          , Ha^Fma      , Ha^Fma      , Aa          , Ha^Fma      , Ha^Fma      , Ha^Voa      , Ha^Fda      , Ha^Fma      , Ms          , Ms          , Ms          , Ms          , Mm^Xm       , Mm^Xm       , Ms          , Ms          , Ai          , Ha^Fpa      , Aa          , Aa          , Aa^Fpa      , Aa^Fpa      , Ha^Fpa      , Gg          
Ha          , Ha^Fpa      , Aa          , Ai          , Aa          , Ha^Fma      , Aa          , Aa          , Gs          , Aa          , Aa          , Ha^Fma      , Ha^Fma      , Ha^Fma      , Ms          , Ha          , Ms          , Ms          , Ms          , Mm^Xm       , Ms          , Ai          , Ha^Fpa      , Ai          , Ai          , Aa          , Ai          , Aa          , Aa          , Aa          
Ha          , Aa          , Ai          , Ai          , Aa          , Aa          , Aa          , Gs          , Aa          , Gs          , Ce          , Ce          , Ce          , Ha^Fma      , Ms          , Ms          , Ms          , Ms^Vhha     , Ms          , Mm^Xm       , Ms          , Ha^Fpa      , Ha^Fpa      , Aa          , Aa          , Ai          , Aa          , Ai          , Ai          , Ai          
Aa          , Aa          , Ai          , Aa          , Aa          , Gs          , Gs          , Gs          , Aa          , Gs          , Ce          , 2 Ke        , Ce          , Ha^Fpa      , Ms          , Mm^Xm       , Mm^Xm       , Ms          , Mm^Xm       , Mm^Xm       , Ms          , Ha^Fpa      , Aa          , Aa          , Gg          , Aa          , Gg          , Aa          , Aa          , Aa          
Aa          , Aa          , Aa          , Ai          , Aa          , Aa          , Gs          , Aa          , Ha^Fma      , Ha^Fma      , Ha^Fma      , Ce          , Ha^Fma      , Ms          , Mm^Xm       , Mm^Xm       , Mm^Xm       , Mm^Xm       , Ms          , Ms          , Ha^Fpa      , Ha^Fpa      , Aa          , Gg          , Aa^Fpa      , Aa^Vca      , Gg          , Aa          , Ha^Fpa      , Ha^Fpa      
Aa          , Aa          , Aa          , Ai          , Ai^Bw/      , Gs          , Ha^Fpa      , Ha^Fma      , Ms          , Ha^Fma      , Ms          , Ha^Fma      , Ms          , Ms          , Mm^Xm       , Mm^Xm       , Ms          , Ms^Vhha     , Ms          , Aa^Fpa      , Aa          , Aa          , Aa^Fpa      , Gg          , Gg          , Aa^Fpa      , Gg          , Aa          , Ha^Fpa      , Ms          
Aa          , Aa          , Aa          , Aa          , Ha^Fpa      , Ai          , Ms          , Ms          , Ms^Vhha     , Ms          , Ha^Fma      , Ms          , Ms          , Ms          , Ms          , Ms          , Aa^Fpa      , Ms          , Ha^Fpa      , Ha^Fpa      , Aa^Fpa      , Aa^Fpa      , Aa^Fpa      , Gg          , Aa          , Gg          , Gg          , Aa          , Ha^Fpa      , Ms          
Ha          , Aa          , Ha          , Ha          , Ms          , Ms          , Mm^Xm       , Ms          , Ms          , Ha^Fma      , Ms          , Ms          , Ha^Fma      , Ms          , Ha^Fpa      , Ha^Fpa      , Aa^Fpa      , Ha^Fpa      , Aa^Fpa      , Aa          , Aa          , Gg          , Gg          , Gg          , Gg          , Aa          , Aa          , Aa          , Ha^Fpa      , Ms          
Ha          , Aa          , Ha          , Ms          , Mm^Xm       , Mm^Xm       , Mm^Xm       , Mm^Xm       , Ms          , Ms          , Ha^Fpa      , Ha^Fpa      , Ai          , Ha^Fpa      , Ai          , Aa^Fpa      , Aa^Fpa      , Aa^Fpa      , Aa^Fpa      , Aa^Fpa      , Gg          , Gg          , Aa          , Gg          , Aa          , Aa^Fpa      , Aa^Fpa      , Ha^Fpa      , Aa          , Ha^Fpa      
Ha          , Aa          , Ha          , Ms          , Mm^Xm       , Mm^Xm       , Ms          , Ms          , Ha^Fpa      , Ha^Fpa      , Aa^Fpa      , Ai          , Ai          , Ai          , Ai          , Aa          , Gg          , Gg          , Aa^Fpa      , Gg          , Aa          , Gg          , Ha          , Aa          , Aa^Fpa      , Aa^Fpa      , Aa          , Aa          , Ha^Fma      , Aa          
Ha          , Gs          , Ha          , Ms          , Ha^Fpa      , Ha^Fpa      , Ms          , Ha^Fpa      , Aa^Fpa      , Aa^Fpa      , Aa^Fpa      , Aa^Fpa      , Aa          , Ai          , Ai          , Aa          , Gg          , Aa^Fpa      , Ha^Fpa      , Aa^Fpa      , Aa^Fpa      , Ha          , Ms          , Aa^Voa      , Ha          , Aa^Fpa      , Aa          , Ha^Fma      , Ms          , Ms          
Ha          , Gs          , Ha          , Ms          , Ha^Fpa      , Ha^Fpa      , Ms          , Aa^Fpa      , Aa^Fpa      , Aa^Vha      , Aa^Fpa      , Gg          , Aa^Fpa      , Ai          , Ai          , Aa          , Aa^Fpa      , Aa^Fpa      , Ha^Fma      , Ha^Fpa      , Ms          , Ms          , Ms          , Ms          , Ha          , Aa          , Aa          , Ha^Fma      , Ms          , Ms          
Ha          , Aa          , Ha          , Ms          , Ha^Fpa      , Aa          , Ha^Fpa      , Aa^Fpa      , Gg          , Aa^Fpa      , Aa          , Gg          , Aa^Fpa      , Ha^Fpa      , Aa^Fpa      , Ai          , Ai          , Ha^Fpa      , Ha^Fma      , Ha^Fma      , Ms          , Ms          , Ha          , Ha          , Aa          , Aa          , Ha^Fpa      , Ha^Fpa      , Ms^Vhha     , Ms          
Ha^Fpa      , Aa          , Aa^Voa      , Ha^Fpa      , Ha^Fpa      , Aa          , Ha^Fpa      , Aa          , Aa          , Gg          , Gg          , Gg          , Aa^Fpa      , Ha^Fpa      , Ha^Fpa      , Aa^Fpa      , Ai          , Ha^Vca      , Ha^Fpa      , Ha^Fpa      , Ha^Fpa      , Ms          , Ha          , Aa          , Gs          , Aa          , Ha^Fpa      , Ms          , Ha^Fpa      , Ms          
Ha          , Aa          , Aa          , Ms          , Ha^Fpa      , Aa          , Ce          , Ce          , Ce          , Aa          , Gg          , Aa^Fma      , Ha^Fpa      , Ha^Fpa      , Ha^Fpa      , Ha^Fpa      , Aa^Fpa      , Ai          , Ai          , Aa^Fpa      , Aa          , Ha^Fpa      , Aa          , Aa          , Gg          , Aa          , Ch          , Ha^Fpa      , Ha^Fpa      , Ms          
Ha          , Aa          , Ha          , Ms          , Ha^Fpa      , Aa          , Ce          , 4 Ke        , Ce          , Aa          , Aa          , Aa^Fpa      , Ha^Fpa      , Ms          , Ha^Fpa      , Ha^Fpa      , Aa^Fpa      , Aa          , Ww          , Aa          , Aa          , Aa          , Gg          , Gg          , Gg          , Ch          , 3 Kh        , Ch          , Ha^Fpa      , Ms          
Ha          , Aa          , Ha          , Ms          , Ha^Fpa      , Ha^Fpa      , Ha^Fpa      , Ce          , Aa          , Ha^Fpa      , Ha^Fpa      , Ha^Fpa      , Ms          , Ms          , Ms          , Aa^Fpa      , Ha^Fpa      , Aa          , Aa          , Ww          , Ai          , Aa          , Gg          , Aa^Vha      , Aa          , Ch          , Ch          , Ch          , Ha^Fpa      , Ms          
Ha^Fma      , Aa          , Ha^Fma      , Ms          , Ms          , Ha^Fpa      , Ha^Fpa      , Ha^Fpa      , Ha^Fpa      , Aa          , Ms          , Ms          , Ms          , Ms^Vhha     , Ms          , Ha^Fpa      , Ha^Fpa      , Aa          , Aa          , Ai          , Ai          , Aa          , Aa          , Gg          , Gg          , Aa          , Aa          , Ha^Fpa      , Ha^Fpa      , Ha^Fpa      
Ha^Fma      , Aa          , Aa          , Ha^Fma      , Ha^Fma      , Ms          , Ms          , Ms          , Ms          , Ha^Fpa      , Ha^Fpa      , Ha^Fpa      , Ms          , Ms          , Ms          , Ha^Fpa      , Ha^Fpa      , Aa          , Ai          , Ai          , Aa          , Aa          , Aa          , Aa          , Gg          , Aa          , Aa          , Aa          , Aa          , Ha^Fpa      
