border_size=1
usage=map

Ms          , Ms          , Ms          , Ms          , Ha^Fpa      , Ha^Fpa      , Ha^Fpa      , Ha^Fpa      , Aa^Fpa      , Aa^Fpa      , Ai          , Aa          , Aa          , Mm          , Ha^Fpa      , Ms          , Ms          , Ms          , Ms          , Ms          , Ms          , Ms          , Ms          , Ms          , Ms          , Ms          
Ms          , Ms          , Ha^Fpa      , Ha^Fpa      , Aa^Fpa      , Aa^Fpa      , Aa^Fpa      , Aa^Fpa      , Ai          , Ai          , Ww          , Ai          , Ai          , Aa          , Aa          , Ha^Fpa      , Ha^Fpa      , Ms          , Ha^Fma      , Ha^Fma      , Ha^Fma      , Ha^Fma      , Ha^Fma      , Ms          , Ms          , Ms          
Ha^Fpa      , Ha^Fpa      , Aa^Fpa      , Aa^Fpa      , Ai          , Ai          , Ai          , Ai          , Ww          , Ww          , Wo          , Ww          , Aa          , Aa          , Rr          , Aa          , Aa          , Ha^Fpa      , Aa          , Aa          , Aa          , Ha^Fma      , Ha^Fma      , Ms          , Ms          , Ms          
Ha^Fpa      , Aa^Fpa      , Aa^Fpa      , Ai          , Ww          , Ww          , Ww          , Ww          , Wo          , Wo          , Ww          , Ww          , Aa          , Cv          , Cv          , Rr          , Rr          , Aa          , Aa          , Rp^Vhc      , Aa          , Ha^Fma      , Ha^Fma      , Ms          , Ms          , Ms          
Aa^Fpa      , Aa^Fpa      , Ww          , Ww          , Ai          , Ww          , Ww          , Ww          , Ww          , Ww          , Aa          , Aa          , Rr          , Rr          , Rr          , Cv          , Rr          , Aa          , Aa          , Aa          , Aa          , Ha^Fpa      , Ms          , Ms          , Ms          , Ms          
Ww          , Ww          , Aa^Fpa      , Aa^Fpa      , Aa^Fpa      , Ai          , Ai          , Ai          , Ai          , Aa          , Aa          , Cv          , Rr          , Rr          , Rr          , Rr          , Ggf         , Rr          , Rr          , Aa          , Ha^Fda      , Ha^Fda      , Ms          , Ms          , Ms          , Ms          
Ha^Fma      , Ww          , Aa^Fpa      , Aa^Vla      , Aa^Fpa      , Aa^Fpa      , Ai          , Ai          , Aa          , Cv          , Rr          , Rr          , Rr          , Rr          , Cv          , Ggf         , Ggf         , Cv          , Rr          , Aa          , Aa          , Ha^Fda      , Ms          , Ms          , Ha^Fma      , Ms          
Ha^Fma      , Ha^Fpa      , Aa^Fpa      , Aa^Fpa      , Aa^Fpa      , Aa^Fpa      , Ai          , Cv          , Rr          , Aa          , Rr          , Rr          , Cv          , Ggf         , Ggf         , Ggf         , Ggf         , Ggf         , Rr          , Cv          , Aa          , Ha^Fda      , Ms          , Ms          , Ha^Fma      , Ha^Fma      
Ha^Fma      , Ha^Fpa      , Ha^Fpa      , Aa^Fpa      , Aa^Fpa      , Aa^Fpa      , Ai          , Aa^Fpa      , Aa          , Rr          , Cv          , Aa          , Aa^Fpa      , Ggf         , Ggf         , Ggf         , Ggf         , Cv          , Rr          , Aa          , Aa          , Ha^Fda      , Ms          , Ms          , Ha^Fma      , Ha^Fda      
Ms          , Ha^Fma      , Ha^Fma      , Ha^Fpa      , Ha^Fpa      , Aa^Fpa      , Aa^Fpa      , Ai          , Ai          , Aa^Fpa      , Aa^Fpa      , Aa^Fpa      , Aa^Fpa      , Ggf         , Aa^Fpa      , Ggf         , Aa          , Aa          , Aa          , Aa          , Ha^Fda      , Ha^Fda      , Ms          , Ms          , Ha^Fma      , Ha^Fda      
Ms          , Ms          , Ms          , Ha^Fma      , Ha^Fpa      , Ha^Fpa      , Ha^Fpa      , Ha^Fpa      , Aa^Fpa      , Ai          , Ai          , Aa^Fpa      , Ha^Fpa      , Aa^Fpa      , Aa^Fpa      , Aa^Fpa      , Aa^Fpa      , Aa          , Aa          , Aa          , Ha^Fda      , Ms          , Ms          , Ms          , Ha^Fma      , Ha^Fda      
Ms          , Ms          , Ms          , Ha^Fma      , Ha^Fma      , Ha^Fda      , Ha^Fda      , Aa^Fpa      , Ms          , Ha^Fpa      , Ms          , Ai          , Ms          , Ha^Fpa      , Ha^Fpa      , Aa^Vea      , Ha^Fpa      , Aa^Fpa      , Aa^Fpa      , Aa          , Ha^Fda      , Ms          , Ha^Fpa      , Ms          , Ha^Fma      , Ha^Fda      
Mm^Xm       , Ms          , Mm^Xm       , Ms          , Ms          , Ms          , Ms          , Ms          , Ms          , Ms          , Ms          , Ms          , Ha          , Ms          , Ms          , Ha^Fpa      , Ms          , Ha^Fpa      , Ha^Fpa      , Aa^Fpa      , Aa^Fpa      , Ha^Fda      , Ha^Fda      , Ms^Vhha     , Ha^Fda      , Gg          
Ms          , Mm^Xm       , Ms          , Mm^Xm       , Mm^Xm       , Mm^Xm       , Mm^Xm       , Mm^Xm       , Mm^Xm       , Mm^Xm       , Mm^Xm       , Ha^Fpa      , Mm^Xm       , Mm^Xm       , Mm^Xm       , Mm^Xm       , Mm^Xm       , Ms          , Ms          , Ha^Fpa      , Ha^Fpa      , Aa^Fpa      , Aa^Fpa      , Ha^Fda      , Gg          , Gg          
Ha^Fpa      , Ms          , Ha^Fpa      , Ms          , Ms          , Ms          , Ms          , Ms          , Ms          , Ms          , Ms          , Mm^Xm       , Ms          , Ms          , Ms          , Ms          , Ms          , Mm^Xm       , Mm^Xm       , Ms          , Ms          , Ha^Fpa      , Aa^Fpa      , Aa          , Gg          , Aa          
Ms          , Ha^Fpa      , Aa^Vea      , Ha^Fpa      , Ha^Fpa      , Ha^Fpa      , Ha^Fpa      , Ha^Fpa      , Ha^Fma      , Ha^Fpa      , Ha^Fma      , Ms          , Ha^Fma      , Ai          , Ha^Fma      , Ha^Fma      , Ha^Fma      , Ms          , Ms          , Ms          , Ms          , Ha^Fpa      , Aa          , Aa          , Aa          , Aa          
Ha^Fma      , Ha^Fma      , Aa^Fpa      , Ha^Fpa      , Aa          , Ha^Fpa      , Ha^Fpa      , Ha^Fpa      , Aa          , Ha^Fpa      , Aa^Fpa      , Ha^Fma      , Aa          , Ai          , Aa          , Aa^Fpa      , Aa^Fpa      , Ha^Fma      , Ha^Fpa      , Ms          , Ha^Fma      , Ha^Fma      , Aa          , Aa          , Ha^Fma      , Ha^Fma      
Aa          , Aa^Fpa      , Aa^Fpa      , Aa          , Aa^Fpa      , Aa          , Aa^Fpa      , Aa^Fpa      , Aa^Fpa      , Aa^Fpa      , Aa^Fpa      , Aa^Fpa      , Aa^Fpa      , Ai          , Ai          , Aa          , Aa          , Aa^Fpa      , Ha^Fma      , Ha^Vhha     , Ha^Fma      , Aa^Fpa      , Aa          , Ha^Fma      , Ms          , Ha^Fma      
Aa          , Aa^Fpa      , Ce          , Ce          , Ce          , Aa^Fpa      , Aa^Fpa      , Aa^Fpa      , Aa^Fpa      , Aa^Fpa      , Aa          , Aa^Vea      , Aa^Fpa      , Aa          , Aa          , Ai          , Ai          , Aa          , Aa          , Aa^Fpa      , Aa          , Aa          , Ce          , Ce          , Ce          , Ms          
Aa^Fpa      , Aa          , Ce          , 1 Ke        , Ce          , Aa^Fpa      , Aa          , Aa^Fpa      , Aa          , Aa          , Aa^Fpa      , Aa          , Aa^Fpa      , Aa^Fpa      , Aa^Fpa      , Ai          , Ai          , Ai          , Aa          , Aa          , Aa          , Aa          , Ce          , 2 Ke        , Ce          , Ms          
Aa          , Aa          , Aa          , Ce          , Aa          , Aa^Fpa      , Aa          , Aa^Fpa      , Aa^Fpa      , Aa^Fpa      , Aa          , Aa          , Aa          , Aa^Fpa      , Aa^Fpa      , Aa^Fpa      , Ai          , Aa          , Aa          , Aa          , Aa          , Aa          , Aa          , Ce          , Ha^Fma      , Ms          
Aa^Fpa      , Aa^Fpa      , Aa          , Aa          , Aa^Fpa      , Aa^Fpa      , Aa          , Aa^Fpa      , Aa^Fpa      , Aa          , Aa^Fpa      , Aa          , Aa^Fpa      , Aa^Fpa      , Aa          , Aa^Fpa      , Aa          , Ai          , Ai          , Ai          , Ai          , Aa          , Aa          , Aa          , Aa          , Ha^Fma      
Aa          , Aa^Fpa      , Aa^Vea      , Aa^Fpa      , Aa          , Aa          , Aa^Fpa      , Aa          , Aa^Fpa      , Aa^Fpa      , Aa          , Aa          , Aa^Vea      , Aa          , Aa^Fpa      , Aa          , Aa^Fpa      , Aa          , Aa          , Ai          , Ww          , Ai          , Ai          , Aa          , Ai          , Aa          
Aa          , Aa^Fpa      , Aa          , Aa^Fpa      , Aa          , Aa          , Aa^Fpa      , Aa^Fpa      , Aa^Fpa      , Aa^Fpa      , Aa          , Aa^Fpa      , Aa^Fpa      , Aa^Fpa      , Aa          , Aa          , Aa^Fpa      , Aa          , Aa          , Ai          , Ww          , Ww          , Ww          , Ai          , Ai          , Ai          
Aa          , Aa          , Aa          , Aa          , Aa          , Aa          , Aa          , Aa          , Aa          , Aa          , Aa          , Aa^Fpa      , Aa          , Aa          , Aa          , Aa          , Aa          , Aa          , Aa          , Aa          , Ai          , Ww          , Ai          , Ai          , Ai          , Ai          
