border_size=1
usage=map

Gg          , Gg          , Gg          , Re^Gvs      , Re^Gvs      , Gg          , Gg          , Gs^Fp       , Gs^Fp       , Gs^Fp       , Gg          , Gs^Fp       , Gs^Fp       , Gs^Fp       , Gs^Fp       , Gs^Fp       , Gs^Fp       , Gs^Fp       , Gs^Fp       , Gg          , Gs^Fp       , Gs^Fp       , Gs^Fmf      , Gs^Fp       , Gg          , Gg          , Gs^Ft       , Gs^Ft       , Ww          , Gg          , Rd          , Rd          , Gg          , Gg          , Gg          , Gg          , Re^Gvs      , Gg          , Gg          , Gg          , Gg          , Gg          , Gg          , Gs^Fp       , Gs^Fp       , Gs^Fp       , Gs^Fp       , Gg          , Gs^Fp       , Gs^Fp       
Rd          , Gg          , Gg          , Re^Gvs      , Gg          , Gg^Vc       , Gg          , Gs^Fp       , Gg          , Gg          , Gg          , Gs^Fp       , Gg          , Gg          , Gg          , Gs^Fp       , Gg          , Gs^Fp       , Gg          , Gg^Vc       , Gg          , Gs^Fmf      , Gs^Fmf      , Gs^Fp       , Gg          , Gg          , Gg          , Gs^Ft       , Ww^Bw/      , Rd          , Gg          , Gg          , Gg          , Gg^Vc       , Gg          , Re^Gvs      , Re^Gvs      , Re^Gvs      , Re^Gvs      , Gg          , Gg          , Gg          , Gs^Fp       , Gs^Fp       , Gs^Fp       , Gg^Ve       , Gs^Fp       , Gs^Fp       , Gg          , Gs^Fp       
Ds          , Rd          , Rd          , Gg          , Rd          , Gg          , Gg          , Gg          , Gg          , Gg          , Gg          , Gg          , Gg          , Gg^Vc       , Gg          , Gs^Fp       , Gg          , Gs^Fp       , Gg          , Gs^Fp       , Gs^Fp       , Gs^Fmf      , Gg          , Gs^Fp       , Gg          , Gg^Vc       , Rd          , Rd          , Ww          , Gg          , Gg          , Gg          , Ds          , Gg          , Ds          , Gg          , Gg          , Gg          , Gg          , Gg^Vc       , Gg          , Gs^Fp       , Gs^Fp       , Gs^Fp       , Ce          , Gs^Fp       , Gs^Fp       , Gs^Fp       , Gg          , Gs^Fp       
Ds          , Ds          , Ds          , Rd          , Ds          , Rd          , Rd          , Rd          , Rd          , Gg          , Rd          , Gg          , Gg          , Gg          , Gg          , Gg          , Gg          , Gg          , Gg          , Gs^Fp       , Gg          , Gs^Fp       , Gg          , Gg          , Rd          , Rd          , Ss          , Ss          , Ww          , Gs^Ft       , Gs^Ft       , Gg          , Ds          , Dd^Dc       , Ds          , Ds          , Gg          , Gg          , Gs^Fp       , Gg          , Gs^Fp       , Gg          , Gs^Fms      , Ce          , 1 Ke        , Ce          , Gs^Fp       , Gs^Fmf      , Gg          , Gs^Fp       
Ds          , Dd^Dc       , Ds          , Ds          , Dd^Vda      , Ds          , Ds          , Ds          , Ds          , Rd          , Ds          , Rd          , Rd          , Rd          , Rd          , Gg          , Rd          , Gg          , Rd          , Gg          , Gg          , Gg          , Rd          , Rd          , Gg          , Gg          , Ss          , Ww          , Ss          , Gs^Ft       , Gg          , Gg          , Gg          , Gg          , Gg          , Gg          , Gg          , Gg          , Gg          , Gs^Fp       , Gs^Fp       , Gs^Fp       , Ggf         , Ce          , Ce          , Ce          , Gs^Fp       , Gs^Fmf      , Gs^Fp       , Gs^Fp       
Ds          , Ds          , Ds          , Ds          , Ds          , Ds          , Ww          , Ds          , Ww          , Ds          , Ww          , Ds          , Ds          , Ds          , Ds          , Rd          , Gg          , Rd          , Gg          , Rd          , Rd          , Rd          , Gg          , Gg          , Ss          , Gg          , Ss          , Ww          , Ss          , Gs^Ft       , Gg          , Gg          , Ds          , Gg          , Gg          , Gg          , Ds          , Gg          , Gg          , Gs^Fp       , Gs^Fp       , Gs^Fp       , Gs^Fp       , Ggf         , Gs^Fp       , Gs^Fp       , Gs^Fp       , Gs^Fp       , Gs^Fmf      , Gs^Fp       
Ds          , Dd^Dc       , Ds          , Ds          , Ss          , Ww          , Ss          , Ww          , Ss          , Ww          , Ss          , Ww          , Ss          , Ds          , Ds          , Ds          , Ds          , Gg          , Gg          , Gg          , Rd          , Gg          , Gg^Vh       , Gg          , Gg          , Ss          , Ww          , Ww          , Gg          , Gg          , Gg          , Gg          , Ds          , Ds          , Ds          , Ds          , Ds          , Gg          , Gg          , Gg          , Gs^Fp       , Gs^Fp       , Ggf         , Ggf         , Gs^Fp       , Gg          , Gg          , Gs^Fp       , Gg^Ve       , Gs^Fp       
Ds          , Ds          , Ss          , Ss          , Rp          , Ce          , Rp          , Ss          , Rp          , Ce          , Rp          , Ss          , Rp          , Ce          , Ds          , Ds          , Ds          , Ce          , Ds          , Rd          , Gg          , Gg          , Gg          , Gg          , Gg          , Ss          , Ww          , Ss          , Gg          , Gg^Vc       , Gg          , Gg          , Ds          , Gg          , Gg          , Ds          , Dd^Vdt      , Ds          , Gg          , Gg          , Gg          , Gs^Fp       , Gg          , Gs^Fp       , Gs^Fp       , Gs^Fp       , Gg          , Gs^Fp       , Gs^Fp       , Gs^Fp       
Ds          , Xos         , Rp          , Rp          , Rp          , Rp          , Rp          , Rp          , Rp          , Rp          , Rp          , Rp          , Rp          , Rp          , Ds          , Ds          , Ds          , Ds          , Rd          , Rd          , Ds          , Gg          , Gg          , Gg          , Gg          , Ss          , Ww          , Ss          , Ds          , Gg          , Ds          , Ds          , Ds          , Gg          , Gg          , Ds          , Ds          , Ds          , Gg          , Gg          , Gs^Fp       , Gs^Fp       , Gg          , Gs^Fp       , Gs^Fp       , Gs^Fp       , Gs^Fp       , Gs^Fp       , Gs^Fp       , Gs^Fp       
Ds          , Xos         , Rp          , Rp          , Rp          , Rp          , Rp          , Rp          , Rp          , Rp          , Ce          , Ce          , Ce          , Rp          , Ds          , Dd^Vdt      , Ds          , Ds          , Rd          , Ds          , Ds          , Ce          , Ds          , Gg          , Gg          , Ss          , Ww          , Gs^Ft       , Gs^Ft       , Ds          , Ds          , Ds          , Ds          , Ds          , Gg          , Gg          , Ds          , Ds          , Gg          , Gg          , Gg          , Gs^Fp       , Gs^Fp       , Gs^Fp       , Gs^Fp       , Gs^Fp       , Gs^Fp       , Gs^Fp       , Gs^Fp       , Gs^Fp       
Ds          , Xos         , Rp          , Rp          , Rp          , Rp          , Rp          , Rp          , Rp          , Rp          , Ce          , 6 Ke        , Ce          , Rp          , Rp          , Ds          , Ds          , Rd          , Ds          , Ds          , Dd          , Ds          , Ds          , Ds          , Ds          , Gs^Ft       , Ww          , Gs^Ft       , Ds          , Ds          , Gg          , Gg          , Gg          , Ds          , Gg          , Gg          , Gg          , Ds          , Gg          , Gg          , Gs^Fp       , Gs^Fp       , Gs^Fp       , Gs^Fp       , Gg^Ve       , Gs^Fp       , Gs^Fms      , Gs^Fp       , Gs^Fp       , Gg          
Ds          , Xos         , Rp          , Rp          , Rp          , Rp          , Rp          , Rp          , Rp          , Rp          , Rp          , Ce          , Rp          , Rp          , Ds          , Ds          , Rd          , Rd          , Ds          , Dd          , Dd^Vdt      , Dd          , Ds          , Ds          , Ds          , Gs^Ft       , Ww          , Ds          , Ds          , Ds          , Ds          , Gg          , Gg          , Gg          , Ds          , Gg          , Gg          , Gg          , Gg          , Gg          , Gg          , Gs^Fp       , Gs^Fp       , Gs^Fp       , Gs^Fms      , Gs^Fp       , Gs^Fp       , Gs^Fp       , Gs^Fp       , Gg          
Ds          , Xos         , Rp          , Rp          , Rp          , Rp          , Rp          , Rp          , Rp          , Rp          , Rp          , Rp          , Ds          , Rp          , Ds          , Ds          , Rd          , Ds          , Ds          , Ds          , Ds          , Ds          , Ds          , Ce          , Ds          , Gs^Ft       , Ww          , Ds          , Dd^Vda      , Ds          , Hd          , Ds          , Ds          , Ds          , Ds          , Gg          , Gg          , Gg          , Gg          , Gg          , Gg          , Gg          , Gg          , Gs^Fp       , Gs^Fp       , Gs^Fms      , Gs^Fp       , Gs^Fp       , Gs^Fp       , Gs^Fp       
Ds          , Xos         , Rp          , Rp          , Rp          , Rp          , Ch          , Rp          , Rp          , Rp          , Rp          , Ds          , Dd^Vda      , Ds          , Ds          , Rd          , Ds          , Ds          , Ce          , Ce          , Ce          , Ds          , Ds          , Ds          , Ds          , Ww          , Ds          , Ds          , Ds          , Ds          , Hd          , Ds          , Gg          , Ds          , Gg          , Ds          , Gg          , Gg          , Gg^Vc       , Gg          , Gs^Fp       , Gs^Fp       , Gs^Fp       , Gg          , Gg          , Gs^Fp       , Gs^Fp       , Gs^Fp       , Gs^Fp       , Gs^Fp       
Ds          , Xos         , Rp          , Rp          , Rp          , Ch          , 5 Kh        , Ch          , Rp          , Rp          , Rp          , Ds          , Ds          , Ds          , Rd          , Rd          , Ds          , Ds          , Ce          , 4 Ke        , Ce          , Ds          , Ds          , Ds          , Ds          , Ww          , Ds          , Ds          , Ds          , Ds          , Ds          , Ds          , Ds          , Gg          , Gg          , Gg          , Re^Gvs      , Re^Gvs      , Gg          , Gg          , Gs^Fp       , Gs^Fp       , Gg          , Gs^Fp       , Gs^Fp       , Gg          , Ce          , Gg^Ve       , Gs^Fp       , Gg          
Ds          , Xos         , Rp          , Rp          , Rp          , Ch          , Ch          , Ch          , Rp          , Rp          , Ds          , Ds          , Ds          , Ds          , Rd          , Ds          , Ds          , Ds          , Ds          , Ce          , Ds          , Ds          , Ds          , Ds          , Ds          , Ww          , Gs^Ft       , Gs^Ft       , Gg          , Gg          , Gg          , Ds          , Gg          , Gg          , Ds          , Gg          , Gg          , Re^Gvs      , Gg          , Gg          , Gs^Fp       , Gs^Fp       , Gg          , Gs^Fp       , Gs^Fp       , Ce          , 2 Ke        , Ce          , Gg          , Gs^Fp       
Ds          , Xos         , Rp          , Rp          , Rp          , Rp          , Rp          , Rp          , Rp          , Rp          , Ds          , Dd^Do       , Ds          , Rd          , Ds          , Ds          , Ds          , Ds          , Ds          , Ds          , Ds          , Ds          , Ds          , Ce          , Ss          , Ww          , Gs^Ft       , Ds          , Ds          , Gg          , Gg          , Gg          , Ds          , Ds          , Ds          , Ds          , Gg          , Gg          , Gg          , Gg          , Gg          , Gs^Fp       , Gs^Fp       , Gs^Fp       , Gs^Fp       , Ce          , Ce          , Ce          , Gg          , Gg          
Ds          , Xos         , Uu          , Rp          , Rp          , Rp          , Rp          , Rp          , Rp          , Rp          , Rp          , Ds          , Ds          , Ds          , Ds          , Dd^Vda      , Ds          , Ds          , Dd          , Ds          , Dd^Vdt      , Ds          , Ds          , Gg          , Ww          , Ww          , Gs^Ft       , Ds          , Ds          , Ds          , Gg          , Ds          , Ds          , Dd^Vdt      , Ds          , Gg          , Gg          , Gg          , Gg^Wm       , Gg          , Gg          , Gs^Fp       , Gg          , Gg          , Gs^Fms      , Gs^Fp       , Gs^Fp       , Gs^Fms      , Gg          , Gs^Fp       
Ds          , Xos         , Uu          , Rp          , Uu          , Rp          , Rp          , Rp          , Ch          , Ch          , Ch          , Rp          , Rp          , Rp          , Rp          , Ds          , Ds          , Ds          , Dd^Dc       , Ds          , Ds          , Ds          , Ds          , Gg          , Ww          , Gs^Ft       , Gs^Ft       , Ds          , Gg          , Gg          , Gg          , Ds          , Dd^Dc       , Ds          , Gg          , Gg          , Gg          , Gg          , Gg          , Gg          , Gg          , Gg          , Gg          , Gs^Fp       , Gs^Fp       , Gs^Fms      , Gg          , Gs^Fms      , Gs^Fp       , Gs^Fp       
Ds          , Xos         , Uu          , Uu          , Uu          , Uu          , Rp          , Rp          , Chr         , 3 Kh        , Ch          , Rp          , Ds          , Ds          , Ds          , Ds          , Ds          , Ds          , Ds          , Ds          , Ds          , Ds          , Gg          , Gg          , Ww          , Gs^Ft       , Ds          , Ds          , Gg          , Gg          , Ds          , Ds          , Ds          , Ds          , Ds          , Gg          , Gg          , Gg          , Ds          , Gg          , Gg          , Gg          , Re^Gvs      , Gg          , Gg          , Gg          , Gg          , Gs^Fms      , Gs^Fp       , Gs^Fp       
Ds          , Xos         , Uu^Uf       , Uu          , Uu          , Uu          , Rp          , Rp          , Rp          , Ch          , Rp          , Rp          , Ds          , Rp          , Rp          , Ds          , Dd^Vdt      , Ds          , Ds          , Ds          , Xos         , Xos         , Gg          , Ww          , Gs^Ft       , Gs^Ft       , Gg          , Ds          , Gg          , Ds          , Ds          , Dd^Vdt      , Ds          , Ds          , Ds          , Gg          , Ds          , Gg          , Ds          , Ds          , Gg          , Gg          , Gg          , Re^Gvs      , Gg          , Gg          , Gg          , Gs^Fp       , Gg          , Gs^Fp       
Ds          , Xos         , Xos         , Uu          , Uu          , Rp          , Rp          , Rp          , Rp          , Rp          , Ds          , Ds          , Rp          , Rp          , Rp          , Ds          , Ds          , Ds          , Xos         , Xos         , Ds          , Gg          , Gg          , Ww          , Gs^Ft       , Gg          , Ds          , Gg          , Gg          , Ds          , Ds          , Ds          , Gg          , Ds          , Ds          , Gg          , Ds          , Ds          , Dd^Vdt      , Ds          , Ds          , Ds          , Ds          , Gg          , Gg          , Gg^Vc       , Gg          , Gg          , Gs^Fp       , Gs^Fp       
Ds          , Ds          , Ds          , Xos         , Xos         , Uu          , Rp          , Ce          , Rp          , Rp          , Ds          , Rp          , Rp          , Ce          , Rp          , Rp          , Xos         , Xos         , Ds          , Ds          , Gg          , Gg          , Ww          , Ww          , Gs^Ft       , Ds          , Dd^Vdt      , Ds          , Gg          , Gg          , Ds          , Ds          , Gg          , Gg          , Gg          , Gg          , Gg          , Ds          , Ds          , Ds          , Ds          , Ds          , Gg          , Ds          , Gg          , Gg          , Gg          , Gg          , Gg          , Gs^Fp       
Ds          , Ds          , Ds          , Ds          , Ds          , Rp          , Rp          , Rp          , Rp          , Ds          , Ds          , Rp          , Rp          , Rp          , Ds          , Ds          , Ds          , Ds          , Ds          , Gg          , Gg          , Gg          , Ww          , Gs^Ft       , Gs^Ft       , Ds          , Ds          , Ds          , Ds          , Ds          , Ds          , Gg          , Gg          , Gg          , Gg          , Gg          , Gg          , Gg          , Gg          , Gg          , Gg          , Gg          , Gg          , Gg          , Gg          , Gg          , Gg          , Gg          , Gg          , Gg          
