border_size=1
usage=map

Ha^Fpa      , Aa          , Aa^Fpa      , Aa^Fpa      , Aa^Fpa      , Ha^Fma      , Ha^Fma      , Ms          , Ms          , Ms          , Ai          , Ai          , Aa          , Aa^Fpa      , Aa          , Aa^Fpa      , Aa^Fpa      , Ha^Fpa      , Aa^Fpa      , Ha^Fpa      , Ha^Fpa      , Ms          , Ha^Fpa      , Ms          , Ms          , Ha          , Ms          , Ha          , Ms          , Ms          
Ha^Fpa      , Aa          , Aa          , Aa^Fpa      , Ce          , Aa^Fpa      , Aa^Fpa      , Ha^Fma      , Ha^Fpa      , Aa          , Ai          , Ha^Fpa      , Aa          , Aa          , Aa^Fpa      , Aa          , Aa^Fpa      , Aa          , Aa^Fpa      , Aa^Fpa      , Aa          , Ha^Fpa      , Aa^Voa      , Ha^Fpa      , Ce          , Ce          , Ce          , Ms          , Ha^Fpa      , Ms          
Aa          , Ha^Fpa      , Aa          , Ce          , 1 Ke        , Ce          , Aa          , Ha^Vca      , Ai          , Ai          , Aa^Fpa      , Aa^Fpa      , Gg          , Aa^Fpa      , Aa^Fpa      , Aa          , Aa^Vha      , Aa^Fpa      , Gg          , Gg          , Gg          , Aa          , Aa          , Ha^Fpa      , Ce          , 5 Ke        , Ce          , Ha^Fpa      , Ha^Fpa      , Ms          
Ha^Fpa      , Ha^Fpa      , Aa          , Ce          , Ce          , Ce          , Aa          , Aa          , Ai^Bw\      , Aa          , Aa^Fpa      , Gs          , Ha^Fpa      , Ha^Fpa      , Ha^Fpa      , Gg          , Gg          , Aa          , Aa^Fpa      , Aa^Fpa      , Aa^Fpa      , Aa          , Aa^Fpa      , Aa          , Gg          , Ce          , Ha^Fpa      , Ha^Fpa      , Ha^Fpa      , Ms          
Ha^Fpa      , Ha^Fpa      , Ha^Fma      , Gg          , Aa^Fpa      , Aa^Fpa      , Ai          , Ai          , Aa          , Gs          , Gs          , Gs          , Ha^Fpa      , Ms          , Ms          , Aa          , Gg          , Aa^Fpa      , Ha^Fpa      , Ha^Fpa      , Ha^Fpa      , Aa^Fpa      , Aa          , Aa          , Gg          , Gg          , Gg          , Ha^Fpa      , Aa^Voa      , Ms          
Ms          , Ha^Fpa      , Ha^Fma      , Gg          , Aa^Fpa      , Aa^Fpa      , Ai          , Aa          , Ha^Fpa      , Ha^Fpa      , Ha^Fpa      , Aa          , Ha^Fpa      , Ms          , Ms          , Ha          , Gg          , Ha^Fpa      , Ms          , Ha^Fpa      , Ms          , Ha^Fpa      , Aa^Fpa      , Gg          , Gg          , Aa          , Aa^Fpa      , Aa          , Ha^Fpa      , Ha^Fpa      
Ms          , Ms          , Ms          , Ha^Vca      , Ha^Fpa      , Ai          , Ha^Fpa      , Ha^Fpa      , Ms          , Ms          , Ha^Fma      , Ha^Fpa      , Ha^Fma      , Ha^Fma      , Ha          , Ha          , Ha^Fpa      , Ha^Fpa      , Ms          , Ms          , Ms          , Ha^Fpa      , Ha^Fpa      , Aa          , Gg          , Aa          , Aa^Fpa      , Aa^Fpa      , Ha^Fpa      , Ha^Fpa      
Ha^Fpa      , Ms          , Ms          , Ms          , Ha^Fpa      , Ai          , Ha^Fpa      , Ms          , Ha^Fpa      , Ha^Fma      , Ha^Fma      , Ha^Voa      , Ha^Fda      , Gg          , Ha^Fpa      , Ha^Fpa      , Ha^Fpa      , Ms          , Ms          , Mm^Xm       , Ms^Vhha     , Ms          , Ai          , Aa^Fpa      , Aa^Fpa      , Gg          , Aa^Fpa      , Aa^Fpa      , Ha^Fpa      , Ha^Fpa      
Ha          , Ha^Fpa      , Ha^Fpa      , Ha^Fpa      , Aa^Fpa      , Ai          , Ha^Fpa      , Ha^Fpa      , Aa          , Aa          , Aa          , Ha^Fma      , Gg          , Gg          , Ha^Fpa      , Ha          , Ms          , Ms          , Ms          , Mm^Xm       , Ms          , Ai          , Ha^Fpa      , Ai          , Ai          , Aa          , Ai          , Aa          , Aa          , Aa          
Aa          , Ha^Fpa      , Aa          , Aa^Fpa      , Ai          , Ai          , Aa          , Aa          , Aa          , Gs          , Ce          , Ce          , Ce          , Ha^Fma      , Ms          , Ha^Fpa      , Ms          , Ms          , Ms          , Mm^Xm       , Ms          , Ha^Fpa      , Ha^Fpa      , Ha^Fpa      , Aa^Fpa      , Ai          , Aa^Fpa      , Ai          , Ai          , Ai          
Aa          , Aa          , Aa          , Aa          , Ai          , Aa          , Gs          , Gs          , Aa          , Gs          , Ce          , 2 Ke        , Ce          , Ha^Fpa      , Ms          , Ms          , Ms^Vhha     , Ms          , Mm^Xm       , Mm^Xm       , Ms          , Ha^Fpa      , Ha^Fpa      , Aa          , Aa          , Gg          , Gg          , Aa^Fpa      , Ha^Fpa      , Ha^Fpa      
Aa          , Aa^Vha      , Aa          , Ai          , Aa          , Aa          , Gs          , Aa          , Ha^Fma      , Ha^Fma      , Ha^Fma      , Ce          , Ha^Fma      , Ms          , Mm^Xm       , Mm^Xm       , Mm^Xm       , Mm^Xm       , Ms          , Ms          , Ha^Fpa      , Ha^Fpa      , Aa          , Aa          , Aa^Fpa      , Aa^Vca      , Gg          , Aa          , Ha^Fpa      , Ha^Fpa      
Aa          , Aa          , Aa          , Ai          , Ai^Bw/      , Gs          , Ha^Fpa      , Ha^Fma      , Ms          , Ha^Fma      , Ms          , Ha^Fma      , Ms          , Ms          , Mm^Xm       , Mm^Xm       , Ms          , Ms          , Ms          , Aa^Fpa      , Aa          , Aa          , Aa^Fpa      , Gg          , Gg          , Aa^Fpa      , Gg          , Aa          , Ha^Fpa      , Ms          
Aa          , Gs          , Gs          , Aa          , Ha^Fpa      , Ai          , Ms          , Ms          , Ms^Vhha     , Ms          , Ha^Fma      , Ms          , Ms          , Ms          , Ms          , Ms          , Aa^Fpa      , Ms          , Ha^Fpa      , Ha^Voa      , Aa^Fpa      , Aa^Fpa      , Aa^Fpa      , Gg          , Aa          , Gg          , Gg          , Aa          , Ha^Fpa      , Ms          
Ha          , Aa          , Ha          , Ha          , Ms          , Ms          , Mm^Xm       , Ms          , Ms          , Ha^Fma      , Ms          , Ms          , Ha^Fma      , Ha^Fpa      , Ha^Fpa      , Ha^Fpa      , Aa^Fpa      , Ha^Fpa      , Aa^Fpa      , Aa          , Aa          , Gs          , Gg          , Gg          , Gg          , Aa          , Aa          , Aa          , Ha^Fpa      , Ms          
Ha          , Aa          , Ha          , Ms          , Mm^Xm       , Mm^Xm       , Mm^Xm       , Mm^Xm       , Ms          , Ms          , Ha^Fpa      , Ha^Fpa      , Aa          , Aa^Voa      , Aa          , Aa^Fpa      , Aa^Fpa      , Aa^Fpa      , Aa^Fpa      , Aa^Fpa      , Gs          , Gs          , Aa          , Gs          , Aa          , Gg          , Aa^Fpa      , Ha^Fpa      , Aa^Fpa      , Ha^Fpa      
Ha          , Aa          , Ha          , Ms          , Mm^Xm       , Mm^Xm       , Ms          , Ms          , Ha^Fpa      , Ha^Fpa      , Aa^Fpa      , Ai          , Ai          , Aa          , Ai          , Aa          , Gs          , Gs          , Aa^Fpa      , Gs          , Aa          , Gs          , Ha          , Aa          , Aa^Fpa      , Gg          , Aa^Fpa      , Aa          , Ha^Fma      , Aa          
Ha          , Gs          , Ha          , Ms          , Ha^Fpa      , Ha^Fpa      , Ms          , Ha^Fpa      , Aa^Fpa      , Aa^Fpa      , Aa^Fpa      , Aa^Fpa      , Aa          , Ai          , Ai          , Aa          , Gs          , Aa^Fpa      , Ha^Fpa      , Aa^Fpa      , Aa^Fpa      , Ha          , Ms          , Aa^Voa      , Ha          , Aa^Fpa      , Aa^Fpa      , Ha^Fma      , Ms          , Ms          
Ha          , Gs          , Ha          , Ms          , Ha^Fpa      , Ha^Fpa      , Ms          , Aa^Fpa      , Aa^Fpa      , Aa^Vha      , Aa^Fpa      , Gs          , Aa^Fpa      , Ai          , Ai          , Aa          , Aa^Fpa      , Aa^Fpa      , Ha^Fma      , Ha^Fpa      , Ms          , Ms          , Ms          , Ms          , Ha          , Aa^Fpa      , Aa          , Ha^Fma      , Ms          , Ms          
Ha          , Aa          , Ha^Voa      , Ms          , Ha^Fpa      , Aa          , Ha^Fpa      , Aa^Fpa      , Gs          , Aa^Fpa      , Aa          , Gs          , Aa^Fpa      , Ha^Fpa      , Aa^Fpa      , Ai          , Ai          , Ha^Fpa      , Ha^Fma      , Ha^Fma      , Ms          , Ms          , Ha          , Ha          , Aa          , Aa          , Ha^Fpa      , Ha^Fpa      , Ms^Vhha     , Ms          
Ha^Fpa      , Aa          , Aa          , Ha^Fpa      , Ha^Fpa      , Aa          , Ha^Fpa      , Aa          , Aa          , Gs          , Gs          , Gs          , Aa^Fpa      , Gs          , Gs          , Aa^Fpa      , Ai          , Ha^Vca      , Ha^Fpa      , Ha^Fpa      , Ha^Fpa      , Ms          , Aa          , Aa          , Gs          , Aa          , Ha^Fpa      , Ms          , Ha^Fpa      , Ms          
Ha          , Aa          , Aa          , Ms          , Ha^Fpa      , Aa          , Ce          , Ce          , Ce          , Aa          , Gs          , Aa^Fma      , Ha^Fpa      , Ha^Fpa      , Ha^Fpa      , Aa          , Aa          , Ai          , Ai          , Aa          , Aa          , Ha          , Aa          , Gs          , Gg          , Aa          , Ch          , Ha^Fpa      , Ha^Fpa      , Ms          
Ha          , Aa          , Ha          , Ms          , Ha^Fpa      , Aa          , Ce          , 4 Ke        , Ce          , Aa          , Aa          , Aa^Fpa      , Ha^Fpa      , Ms          , Ha^Fpa      , Ha^Fpa      , Aa^Fpa      , Aa          , Ww          , Gs          , Gs          , Aa          , Gg          , Gg          , Gg          , Ch          , 3 Kh        , Ch          , Ha^Fpa      , Ms          
Ha          , Aa          , Ha          , Ms          , Ha^Fpa      , Ha^Fpa      , Ha^Fpa      , Ce          , Aa          , Ha^Fpa      , Ha^Fpa      , Ha^Fpa      , Ms          , Ms          , Ms          , Aa^Fpa      , Aa^Fpa      , Ai          , Gs          , Gs          , Gs          , Gs          , Gg          , Aa          , Aa          , Ch          , Ch          , Ch          , Ha^Fpa      , Ms          
Ha^Fma      , Aa          , Ha^Fma      , Ms          , Ms^Vhha     , Ha^Fpa      , Ha^Fpa      , Ha^Fpa      , Ha^Fpa      , Aa          , Ms          , Ms          , Ms          , Ms^Vhha     , Ms          , Ha^Fpa      , Ai          , Ai          , Aa          , Gs          , Gs          , Aa          , Aa          , Gg          , Gg          , Aa          , Aa          , Ha^Fpa      , Ha^Fpa      , Ha^Fpa      
Ha^Fma      , Aa          , Aa          , Ha^Fma      , Ha^Fma      , Ms          , Ms          , Ms          , Ms          , Ha^Fpa      , Ha^Fpa      , Ha^Fpa      , Ms          , Ms          , Ms          , Ha^Fpa      , Ai          , Aa          , Aa          , Aa          , Aa          , Aa          , Aa          , Aa          , Gg          , Aa          , Aa          , Aa          , Aa          , Ha^Fpa      
