border_size=1
usage=map

Ha^Fpa      , Aa          , Aa^Fpa      , Aa^Fpa      , Aa^Fpa      , Ha^Fma      , Ha^Fma      , Ms          , Ms          , Ms          , Ai          , Ai          , Ai          , Aa^Fpa      , Aa          , Aa^Fpa      , Aa^Fpa      , Ha^Fpa      , Aa^Fpa      , Ha^Fpa      , Ha^Fpa      , Ms          , Ha^Fpa      , Ms          , Ha          , Ms          , Ms          , Ha^Fpa      , Aa          , Aa          , Gs          , Aa          
Ha^Fpa      , Aa          , Aa          , Aa^Fpa      , Ce          , Aa^Fpa      , Aa^Fpa      , Ha^Fma      , Ha^Fpa      , Aa          , Ai          , Ha^Fpa      , Aa          , Ai          , Aa^Fpa      , Aa^Vha      , Aa^Fpa      , Aa          , Gs^Fp       , Aa^Fpa      , Aa          , Ha^Fpa      , Aa^Fpa      , Ha^Fpa      , Aa^Voa      , Ha^Fma      , Ha^Fpa      , Ha^Fpa      , Aa          , Gs          , Aa          , Aa          
Aa          , Ha^Fpa      , Aa          , Ce          , 1 Ke        , Ce          , Gg          , Ha^Vca      , Ai          , Ai          , Aa^Fpa      , Aa^Fpa      , Gg          , Ai          , Ai          , Aa          , Aa          , Gs^Fp       , Gs          , Gs          , Gs          , Gs          , Gs          , Aa^Fpa      , Aa          , Aa          , Ce          , Aa          , Gs          , Gs          , Aa          , Aa^Fpa      
Ha^Fpa      , Ha^Fpa      , Aa          , Ce          , Ce          , Ce          , Aa          , Aa          , Ai^Bw\      , Aa^Fma      , Gs^Fp       , Gs^Fp       , Aa          , Gg          , Aa          , Ai^Bw/      , Aa          , Aa          , Ha^Fpa      , Gs^Fp       , Ha^Fpa      , Aa          , Aa^Fma      , Aa          , Gs          , Ce          , 5 Ke        , Ce          , Aa          , Aa          , Ha^Fpa      , Ha^Fpa      
Ha^Fpa      , Ha^Fpa      , Ha^Fma      , Gg          , Aa^Fpa      , Aa^Fpa      , Ai          , Ai          , Aa^Fma      , Gg          , Aa          , Aa          , Ha^Fpa      , Aa^Fpa      , Ha^Fpa      , Ai          , Ha^Fpa      , Ha^Fpa      , Ms          , Ha^Fpa      , Ms          , Ha^Fma      , Aa          , Aa          , Gs          , Ce          , Ce          , Ce          , Aa^Fpa      , Ha^Fpa      , Ms          , Ms          
Ms          , Ha^Fpa      , Ha^Fma      , Gg          , Aa^Fpa      , Aa^Fpa      , Ai          , Aa          , Ha^Fpa      , Ha^Fpa      , Ha^Fpa      , Aa^Fma      , Ha^Fpa      , Ha^Fpa      , Ms          , Ai          , Ha^Fpa      , Ms          , Mm^Xm       , Ms          , Ms          , Ha^Fpa      , Aa^Fpa      , Gs          , Gs          , Aa          , Aa^Fma      , Aa^Fpa      , Ha^Fpa      , Ms          , Ms^Vhha     , Ms          
Ms          , Ms          , Ms          , Ha^Vca      , Ha^Fpa      , Ai          , Ha^Fpa      , Ha^Fpa      , Ms          , Ms          , Ha^Fma      , Ha^Fpa      , Ha          , Ha^Fma      , Ha^Fpa      , Ai          , Ha^Fpa      , Ms          , Mm^Xm       , Mm^Xm       , Ms          , Ha^Fpa      , Ha^Fpa      , Aa          , Gs          , Aa          , Aa^Fma      , Aa^Fpa      , Ha^Fpa      , Ms          , Ms          , Ms          
Ha^Fpa      , Ms          , Ms          , Ms          , Ha^Fpa      , Ai          , Ha^Fpa      , Ms          , Ha^Fma      , Ms          , Ha^Fma      , Ms          , Ha          , Ai          , Ai          , Ai          , Ha^Fpa      , Ms          , Mm^Xm       , Mm^Xm       , Ms^Vhha     , Ha^Fpa      , Ha^Fpa      , Ha^Fma      , Aa^Fma      , Gs          , Aa^Fma      , Aa^Fpa      , Aa^Fpa      , Ha^Fpa      , Ms          , Ms          
Ha          , Ha^Fpa      , Ha^Fpa      , Ha^Fpa      , Aa^Fma      , Ai          , Aa^Fma      , Ha^Fma      , Aa          , Ha          , Aa          , Ha^Fma      , Gs          , Gs          , Ha^Voa      , Ai          , Ai          , Ms          , Ms          , Mm^Xm       , Ms          , Ai          , Ai          , Ai          , Ai          , Gs          , Ai          , Aa          , Aa          , Ha^Fpa      , Ha^Fpa      , Ha^Fpa      
Aa          , Ha^Fpa      , Aa^Fma      , Aa^Fma      , Ai          , Ai          , Aa^Fma      , Gs          , Aa          , Aa          , Gs          , Aa          , Gs          , Ha^Fma      , Ha^Fpa      , Ha^Fpa      , Ms          , Ai          , Ms          , Mm^Xm       , Ms          , Ha^Fpa      , Ha^Fpa      , Ha^Fma      , Aa^Fma      , Ai          , Aa^Fma      , Ai          , Ai          , Ai          , Ai          , Ha^Fpa      
Aa          , Aa          , Aa          , Aa^Fma      , Ai          , Aa^Fma      , Gs          , Gs          , Gs          , Gs          , Ce          , Ce          , Ce          , Ha^Fpa      , Ms          , Ms          , Ms          , Ms          , Mm^Xm       , Mm^Xm       , Ms          , Ha^Fpa      , Ha^Fpa      , Aa          , Aa          , Gg          , Gg          , Aa^Fpa      , Ha^Fpa      , Ha^Fpa      , Ha^Fpa      , Ai          
Aa          , Aa^Vha      , Aa          , Ai          , Aa^Fma      , Aa^Fma      , Gs          , Aa          , Aa^Fma      , Gs          , Ce          , 2 Ke        , Ce          , Ha^Fma      , Ms          , Ms          , Mm^Xm       , Mm^Xm       , Ms          , Ms          , Ha^Fpa      , Ha^Fpa      , Aa          , Aa          , Aa^Fpa      , Aa^Fma      , Gg          , Aa          , Ha^Fpa      , Ha^Fpa      , Ms          , Ha^Fpa      
Aa          , Aa          , Aa          , Ai          , Ai^Bw/      , Gs          , Aa          , Aa          , Ha^Fma      , Aa^Fma      , Ha^Fma      , Ce          , Ha^Fma      , Ms          , Ms          , Mm^Xm       , Ms          , Ms          , Ms          , Aa^Fpa      , Aa          , Aa          , Aa^Fpa      , Gs^Fp       , Gg          , Aa          , Gg          , Aa          , Aa^Fpa      , Ha^Fda      , Ms          , Ms          
Gs          , Gs          , Gs          , Gs          , Ha^Fpa      , Ai          , Ha^Fpa      , Ha^Fpa      , Ms          , Ha^Fma      , Ms          , Ms          , Ms          , Ms          , Ms          , Ms          , Ha^Fma      , Ha^Voa      , Ha^Fpa      , Ha          , Aa^Fpa      , Aa^Fma      , Aa^Fpa      , Gg          , Aa          , Gg          , Gs^Fp       , Gg          , Gs^Fp       , Ha^Fda      , Ms          , Ms          
Aa          , Aa          , Aa          , Aa          , Ha^Fpa      , Ha^Fpa      , Ms          , Ms^Vhha     , Ha^Fda      , Ms          , Ms          , Ms          , Ha^Fma      , Ms          , Ha^Fpa      , Ha^Fpa      , Aa^Fpa      , Ha^Fpa      , Aa^Fpa      , Aa          , Aa          , Gs          , Aa          , Aa          , Gg          , Aa^Fma      , Aa^Fpa      , Gs^Fp       , Ha^Fpa      , Ha^Voa      , Ms          , Ms          
Ms          , Aa          , Ha^Fpa      , Ha^Fpa      , Ms          , Ms          , Mm^Xm       , Ms          , Ms          , Ms          , Ha^Fpa      , Ha^Fpa      , Aa^Fma      , Ha^Fpa      , Aa^Fma      , Aa^Fpa      , Gs^Fp       , Aa^Fpa      , Aa^Fpa      , Aa^Fma      , Gs          , Gs          , Aa          , Gs          , Aa          , Gs^Fp       , Aa^Fpa      , Ha^Fpa      , Aa^Fpa      , Ha^Fpa      , Ha^Fpa      , Ms          
Ms          , Ha^Fpa      , Ms          , Ms          , Mm^Xm       , Mm^Xm       , Ms          , Mm^Xm       , Ms          , Ms          , Ha^Fma      , Ai          , Ai          , Aa^Fma      , Gs          , Gs          , Gs          , Gs          , Gs^Fp       , Gs          , Aa          , Aa          , Ha          , Ha^Fpa      , Ha^Fpa      , Ha^Fma      , Ha^Fma      , Aa          , Aa          , Aa          , Ha^Fpa      , Ms          
Ms          , Ms          , Ha^Fpa      , Ms          , Ms          , Ms          , Ms          , Ms          , Ha^Fpa      , Ha^Fpa      , Aa^Fpa      , Aa^Fpa      , Aa          , Ai          , Aa          , Aa          , Gs          , Gs^Fp       , Ha^Fpa      , Aa^Fpa      , Ha^Fma      , Ha          , Ms          , Ms          , Ms          , Ms          , Ha^Fma      , Aa^Fpa      , Ha^Fma      , Ha^Fpa      , Ms          , Ms          
Ms          , Ha^Fma      , Ms          , Ms          , Ha^Fpa      , Ha^Fpa      , Ms          , Ha^Fma      , Aa^Fpa      , Aa^Fpa      , Aa^Vha      , Gs          , Aa^Fpa      , Ai          , Ai          , Aa          , Aa^Fpa      , Aa^Fpa      , Ha^Fma      , Ms          , Ms          , Ms          , Ha^Fma      , Ms          , Ha^Fpa      , Ha^Fma      , Aa          , Aa^Fpa      , Ha^Fma      , Ms          , Ms          , Ms          
Ha^Fpa      , Ha^Fma      , Ha^Voa      , Ha^Fma      , Ha^Fpa      , Ha^Fpa      , Ha^Fpa      , Ha^Fma      , Aa^Fma      , Aa^Fpa      , Aa          , Gs          , Gs^Fp       , Ha^Fpa      , Aa^Fpa      , Ai          , Ai          , Ha^Fpa      , Ms          , Ms          , Ms          , Ha^Voa      , Ha^Fpa      , Ha^Fpa      , Gs          , Gs          , Gs          , Aa^Fpa      , Aa^Fma      , Ha^Fma      , Ms          , Ms          
Aa^Fma      , Ha^Fma      , Aa^Fma      , Aa^Fda      , Aa^Fma      , Aa^Fda      , Ha^Fpa      , Aa^Fma      , Gs          , Aa          , Gs          , Gs          , Gs^Fp       , Gs          , Gs          , Aa^Fpa      , Ai          , Ha^Fpa      , Ha^Fpa      , Ha          , Ha^Fpa      , Ms          , Ha^Fpa      , Aa          , Gs          , Gs          , Gs          , Gs          , Aa^Fma      , Ha^Fpa      , Ms          , Ms          
Gs          , Aa^Fma      , Aa          , Aa^Fma      , Aa          , Aa^Fma      , Aa^Fma      , Aa^Fma      , Gs          , Gs          , Aa^Fda      , Aa^Fma      , Ha^Fpa      , Gs^Fp       , Aa^Fpa      , Aa          , Aa          , Ai          , Ai          , Aa^Fma      , Aa^Fma      , Ha^Fpa      , Aa          , Aa          , Gs          , Gs          , Aa          , Ce          , Ha^Fma      , Ha^Fma      , Ms          , Ms          
Aa          , Gs          , Gs          , Gs          , Gs          , Gs          , Ce          , Ce          , Ce          , Gs          , Aa^Fma      , Aa^Fma      , Ha^Fpa      , Ha^Fpa      , Ha^Fpa      , Gs^Fp       , Gs^Fp       , Aa          , Ww          , Gs          , Aa^Fma      , Aa          , Gg          , Gg          , Gs          , Aa          , Aa^Fma      , Ha^Fma      , Ha^Fpa      , Ms          , Ms          , Ms          
Aa^Fda      , Aa          , Aa          , Gs          , Aa          , Gs          , Ce          , 4 Ke        , Ce          , Aa^Fma      , Ha^Fpa      , Ha^Fpa      , Ms          , Ms          , Ms          , Ha^Fpa      , Gs^Fp       , Ww          , Gs          , Gs          , Gs          , Aa          , Gg          , Aa          , Ce          , Ce          , Ce          , Aa^Fma      , Aa          , Ha^Fpa      , Ha^Fma      , Ms          
Aa^Fda      , Aa^Fda      , Ha^Fma      , Aa^Fma      , Ha^Fma      , Aa^Fma      , Aa^Fma      , Ce          , Aa^Fma      , Ha^Fma      , Ha^Fpa      , Ms          , Ms          , Ms          , Ha^Fpa      , Ha^Fpa      , Aa          , Ww          , Gs          , Gs          , Gs          , Ce          , Gs          , Aa          , Ce          , 3 Ke        , Ce          , Gs          , Aa^Voa      , Aa          , Ha^Fpa      , Ms          
Ha^Fpa      , Ha^Fpa      , Ha^Fma      , Ha^Fma      , Ms          , Ha^Fpa      , Ha^Fpa      , Ha^Fpa      , Ha^Fpa      , Ha^Fpa      , Ha^Fpa      , Ha^Fpa      , Ms          , Ms          , Ms          , Ha^Fma      , Aa^Voa      , Ai          , Ww          , Gs          , Aa          , Aa          , Gs          , Gs          , Gs          , Ce          , Gs          , Gs          , Gs          , Aa          , Ha^Fpa      , Ha^Fpa      
Ms          , Ms          , Ha^Fma      , Ms          , Ms^Vhha     , Ms          , Ms          , Ms          , Ms          , Ms          , Ms          , Ms          , Ha^Fma      , Ms          , Ms          , Ha^Fpa      , Ha^Fpa      , Aa          , Ai          , Aa          , Aa^Fma      , Aa^Fma      , Aa          , Gs          , Aa          , Aa          , Gs          , Gs          , Aa          , Aa          , Aa^Fma      , Ha^Fpa      
Ms          , Ms          , Ms          , Ms          , Ms          , Ms          , Ms          , Ms          , Ms          , Ms          , Ms          , Ms          , Ms          , Ms          , Ms          , Ms          , Ms          , Ha^Fpa      , Ha^Fpa      , Ai          , Ha^Fpa      , Ha^Fpa      , Ha^Fpa      , Aa^Fma      , Ha^Fpa      , Aa          , Aa          , Gs          , Gs          , Aa          , Ha^Fpa      , Ha^Fpa      
