border_size=1
usage=map

Uu          , Rr          , Rr          , Uu          , Uu          , Uu          , Uu          , Uu          , Uu          , Uu          , Wwf         , Wwf         , Wwf         , Wwf         , Wwf         , Wwf         , Wwf         , Wwf         , Wwf         , Wwf         , Wwf         , Mm          , Mm          , Mm          , Wo          , Wo          , Mm          , Mm          , Mm          , Mm          , Mm          , Mm          , Xu          , Xu          , Xu          , Xu          , Xu          , Xu          , Uu          , Uu          , Xu          , Xu          
Uu          , Rr          , Rr          , Rr          , Rr          , Uu          , Uu^Vud      , Uu          , Uu          , Uu          , Uu          , Wwf         , Wwf         , Wwf         , Ww          , Wwf         , Ww          , Wwf         , Ww          , Wwf         , Ww          , Wwf         , Mm          , Wo          , Mm          , Wo          , Mm          , Mm          , Wwf         , Wo          , Mm          , Mm          , Xu          , Cud         , Cud         , Cud         , Cud         , Xu          , Xu          , Uu          , Uh          , Xu          
Uu          , Rr          , Rr          , Rr          , 1 Rr        , Uu          , Uu          , Uu          , Uu          , Uu          , Ur          , Wwf         , Xu          , Wwf         , Wwf         , Wwf         , Xu          , Wwf         , Xu          , Wwf         , Wwf         , Wwf         , Wwf         , Mm          , Wwf         , Mm          , Wwf         , Wwf         , Wwf         , Ww          , Mm          , Cud         , Xu          , Xu          , Xu          , Xu          , Uu          , Cud         , Xu          , Cud         , Uu          , Xu          
Uu          , Rr          , Uu          , Rr          , Uu          , Uu          , Wwf         , Wwf         , Wwf         , Uu          , Wwf         , Xu          , Ww          , Xu          , Xu          , Xu          , Ww          , Xu          , Ww          , Xu          , Xu          , Xu          , Xu          , Xu          , Xu          , Ww          , Wo          , Wo          , Wo          , Mm          , Ww^Vm       , Wwf         , Xu          , Cud         , Xu          , Uu^Vu       , Uu          , Cud         , Xu          , Uu          , Uu          , Xu          
Uu          , Uu          , Uu          , Uu          , Uu          , Uu          , Wwf         , Wwf         , Ww          , Wwf         , Wwf         , Wwf         , Wwf         , Ww          , Ww          , Ww          , Wwf         , Wwf         , Wwf         , Ww          , Ww          , Xu          , Xu          , Cud         , Xu          , Wo          , Ww          , Ww          , Mm          , Mm          , Mm          , Wwf         , Xu          , Xu          , Xu          , Uu^Vu       , Uu          , Cud         , Cud         , Uu          , Xu          , Xu          
Uu          , Uu          , Wwf         , Uu          , Wwf         , Wwf         , Wwf         , Ww          , Ww^Vm       , Ww          , Wwf         , Wwf         , Ss          , Ss          , Wwf         , Wwf         , Ss          , Xu          , Wwf         , Ww          , Ww^Vm       , Ww          , Xu          , Cud         , Xu          , Mm          , Mm          , Mm          , Wo          , Wo          , Mm          , Cud         , Xu          , Cud         , Cud         , Xu          , Xu          , Cud         , Cud         , Cud         , Cud         , Xu          
Wwf         , Wwf         , Wwf         , Wwf         , Wwr         , Wwf         , Wwf         , Ww          , Ww          , Ww          , Wwf         , Wwf         , Chs         , Chs         , Chw         , Wwf         , Ss          , Xu          , Wwf         , Ww          , Ww          , Ww          , Wwf         , Xu          , Ss          , Ss          , Wwf         , Mm          , Mm          , Mm          , Wwf         , Mm          , Xu          , Uu          , Uu          , Cud         , Cud         , Xu          , Cud         , Cud         , Cud         , Xu          
Wwf         , Wwf         , Ww^Vm       , Wwf         , Wwr         , Wwr         , Wwf         , Wwf         , Wwf         , Wwf         , Wwf         , Ss          , Chw         , 4 Khs       , Chw         , Wwf         , Ss          , Xu          , Xu          , Wwf         , Wwf         , Wwf         , Ss          , Wwf         , Wwf         , Wwf         , Xu          , Ss          , Ss          , Wwf         , Xu          , Xu          , Uu          , Uu          , Uu^Ufi      , Uu          , Uu          , Xu          , Cud         , Uu^Vud      , Cud         , Xu          
Xu          , Wwf         , Wwf         , Wwf         , Xu          , Wwr         , Xu          , Wwf         , Xu          , Xu          , Wwf         , Wwf         , Wwf         , Chw         , Ss          , Ss          , Ss          , Xu          , Ds          , Xu          , Xu          , Ss          , Ww          , Wwf         , Xu          , Xu          , Wwf         , Xu          , Xu          , Xu          , Ww          , Xu          , Xu          , Uu          , Uu          , Uu          , Uu          , Xu          , Cud         , Cud         , Cud         , Xu          
Xu          , Xu          , Xu          , Xu          , Wwf         , Xu          , Wwr         , Xu          , Wwf         , Wwf         , Wwf         , Ww          , Ww          , Wwf         , Wwf         , Wwf         , Xu          , Xu          , Wwf         , Ww          , Ww          , Ww          , Xu          , Xu          , Wwf         , Wwf         , Wwf         , Wwf         , Ww          , Ww          , Wo          , Ww          , Xu          , Uu          , Uu          , Cud         , Uh          , Xu          , Cud         , Cud         , Cud         , Xu          
Ww          , Wwf         , Wwf         , Wwf         , Wwf         , Wwr         , Wwr         , Wwr         , Wwf         , Ww^Vm       , Wwf         , Wwf         , Wwf         , Wwf         , Xu          , Xu          , Wwr         , Wwf         , Xu          , Xu          , Xu          , Xu          , Wwf         , Wwf         , Wwf         , Wwf         , Ww          , Xos         , Xos         , Wwf         , Wwf         , Ww          , Wwf         , Xu          , Xu          , Uh          , Xu          , Xu          , Cud         , Cud         , Cud         , Xu          
Ww          , Wwf         , Ww^Vm       , Wwf         , Xu          , Wwf         , Xu          , Xu          , Xu          , Wwf         , Xu          , Xu          , Xu          , Xu          , Ww          , Wwr         , Xu          , Xu          , Wwf         , Wwf         , Wwf         , Wwf         , Ww^Vm       , Wwf         , Ww          , Ww          , Wo          , Wo          , Wo          , Xos         , Wwf         , Wwf         , Ww^Vm       , Wwf         , Xu          , Xu          , Uu          , Uu          , Cud         , Cud         , Cud         , Xu          
Ds          , Wwf         , Wwf         , Wwf         , Wwf         , Xu          , Wwf         , Wwf         , Wwf         , Xu          , Ww          , Ww          , Ww          , Ww          , Xu          , Xu          , Wwf         , Wwf         , Mm          , Mm          , Mm          , Wwf         , Wwf         , Wwf         , Wo          , Wo          , Wo          , Wo          , Wo          , Xos         , Wwf         , Wwf         , Wwf         , Wwf         , Ds          , Uu          , Uu^Uf       , Ur          , Uu          , Uu          , Uu          , Xu          
Xu          , Ds          , Ds          , Ds          , Xu          , Wwf         , Ss          , Ss          , Ss          , Wwf         , Ww          , Ww^Vm       , Ds          , Xu          , Wwf         , Wwf         , Ww^Vm       , Mm          , Ww          , Ww          , Wo          , Mm          , Mm          , Mm          , Mm          , Wo          , Wo          , Wo          , Xos         , Xos         , Xos         , Wwf         , Ds          , Wwf         , Ds          , Ur          , Uu          , Uu          , Uu^Vud      , Uu          , Ql          , Ql          
Xu          , Xu          , Xu          , Xu          , Wwf         , Xu          , Xu          , Xu          , Xu          , Ss          , Wwf         , Ww          , Ds          , Xu          , Mm          , Mm          , Mm          , Mm          , Mm          , 3 Khw       , Chw         , Ww          , Ww          , Mm          , Xos         , Wo          , Xos         , Xos         , Ql          , Ql          , Ql          , Xos         , Xos         , Ds          , Uu          , Uu          , Xos         , Uu          , Uu          , Uu          , Ql          , Ql          
Wwf         , Wwf         , Wwf         , Wwf         , Ds          , Wwf         , Wwf         , Wwf         , Wwf         , Ss          , Wwf         , Wwf         , Xu          , Xu          , Mm          , Chw         , Chw         , Mm          , Mm          , Ww          , Ww          , Ww          , Xos         , Xos         , Ql          , Xos         , Ql          , Ql          , Ql          , Ql          , Ql          , Ql          , Ql          , Xos         , Xos         , Xos         , Ql          , Xos         , Xos         , Ql          , Ql          , Ql          
Wwf         , Wwf         , Ss          , Ds          , Xu          , Ds          , Wwf         , Ww^Vm       , Wwf         , Wwf         , Xu          , Xu          , Ql          , Qxu         , Qxu^Bs/     , Mm          , Mm          , Mm          , Xos         , Xos         , Xos         , Xos         , Ql          , Ql          , Ql          , Ql          , Ql          , Ql          , Ql          , Ql          , Xos         , Ql          , Ql          , Ql          , Ql          , Ql          , Ql          , Ql          , Ql          , Xos         , Xos         , Ql          
Wwr         , Wwf         , Ss          , Ss          , Ss          , Xu          , Ss          , Wwf         , Ss          , Xu          , Ql          , Ql          , Cud         , Cud         , Ql          , Qxu         , Qxu         , Xos         , Qxu         , Qxu         , Ql          , Ql          , Ql          , Ql          , Ql          , Ql          , Ql          , Ql          , Xos         , Xos         , Ql          , Xos         , Xos         , Ql          , Ql          , Ql          , Ql          , Ql          , Qlf         , Ql          , Ql          , Xos         
Ww          , Wwf         , Wwf         , Wwf         , Ss          , Xu          , Xu          , Xu          , Xu          , Xu          , Ql          , Ql          , Cud         , Ql          , Ql          , Ql          , Ql          , Qxu         , Ql          , Ql          , Ql          , Ql          , Ql          , Ql          , Ql          , Ql          , Xos         , Xos         , Cud         , Ql          , Ql          , Ql          , Ql          , Xos         , Xos         , Xos         , Xos         , Ql          , Ql          , Qlf         , Ql          , Ql          
Ww          , Wwf         , Ww          , Ww^Vm       , Ww          , Ss          , Xu          , Ql          , Ql          , Ql          , Cud         , Cud         , Ql          , Ql          , Ql          , Ql          , Ql          , Ql          , Ql          , Ql          , Ql          , Ql          , Ql          , Ql          , Xos         , Xos         , Cud         , Cud         , Cud         , Ql          , Qlf         , Qlf         , Qlf         , Ql          , Ql          , Ql          , Ql          , Xos         , Xos         , Ql          , Ql          , Ql          
Ww          , Wwr         , Wwr         , Ww          , Ww          , Ww          , Ww          , Xu          , Ql          , Ql          , Cud         , Ql          , Uu          , Ql          , Ql          , Ql          , Ql          , Ql          , Ql          , Ql          , Ql          , Ql          , Xos         , Xos         , Cud         , Cud         , Cud         , Cud         , Cud         , Ql          , Qlf         , Ql          , Ql          , Qlf         , Qlf         , Ql          , Ql          , Ql          , Ql          , Xos         , Xos         , Ql          
Ww          , Wwr         , Wwr         , Wwr         , Wwr         , Wwr         , Ww          , Xu          , Ql          , Ql          , Cud         , Ql          , Ql          , Ql          , Uu          , Ql          , Uu          , Uu          , Uu          , Uu          , Uu          , Xos         , Cud         , Cud         , Cud         , Cud         , Ch          , Cud         , Cud         , Ql          , Ql          , Qlf         , Qlf         , Qlf         , Ql          , Ql          , Ql          , Ql          , Ql          , Ql          , Ql          , Xos         
Ww          , Wwr         , Chw         , Chw         , Chw         , Wwr         , Ww          , Xu          , Ql          , Ql          , Ql          , Cud         , Cud         , Uu          , Ch          , Uu          , Cud         , Uu          , Cud         , Uu          , Cud         , Cud         , Cud         , Cud         , Cud         , Cud         , Cud         , Cud         , Ql          , Ql          , Cud         , Ql          , Ql          , Qlf         , Ql          , Uu^Vud      , Ql          , Qlf         , Qlf         , Ql          , Ql          , Ql          
Ww          , Ww          , Chw         , 2 Khw       , Chw         , Ww          , Ww          , Xu          , Ql          , Uu          , Ql          , Ql          , Ql          , Cud         , Cud         , Cud         , Cud         , Cud         , Cud         , Cud         , Cud         , Cud         , Cud         , Cud         , Cud         , Cud         , Cud         , Cud         , Ql          , Cud         , Cud         , Cud         , Ql          , Qlf         , Qlf         , Ql          , Qlf         , Qlf         , Ql          , Qlf         , Qlf         , Ql          
Wwr         , Wwr         , Wwr         , Chw         , Wwr         , Wwr         , Ww          , Xu          , Ql          , Ql          , Ql          , Ql          , Ql          , Uu          , Ch          , Cud         , Cud         , Cud         , Cud         , Cud         , Cud         , Cud         , Cud         , Cud         , Cud         , Cud         , Cud         , Cud         , Ql          , Cud         , Cud         , Cud         , Ql          , Qlf         , Ql          , Ql          , Ql          , Qlf         , Qlf         , Qlf         , Ql          , Ql          
Ww          , Wwr         , Ww          , Wwr         , Wwr         , Ww          , Ww          , Xu          , Ql          , Ql          , Ql          , Ql          , Ql          , Uu          , Uu          , Uu          , Uu          , Uu          , Uu          , Uu          , Uu          , Cud         , Cud         , Cud         , Cud         , Cud         , Ch          , Cud         , Cud         , Ql          , Ql          , Ql          , Qlf         , Qlf         , Ql          , Uu^Vud      , Ql          , Qlf         , Ql          , Ql          , Ql          , Ql          
Ww          , Ww          , Ww          , Wwf         , Wwr         , Wwr         , Xu          , Xu          , Xu          , Ql          , Uu          , Ql          , Ql          , Ql          , Ql          , Ql          , Ql          , Uu          , Ql          , Uu          , Ql          , Xos         , Xos         , Cud         , Cud         , Cud         , Cud         , Cud         , Cud         , Ql          , Qlf         , Qlf         , Ql          , Qlf         , Qlf         , Ql          , Ql          , Ql          , Ql          , Ql          , Xos         , Xos         
Xu          , Ww          , Ds          , Ds          , Ds          , Xu          , Ds          , Ds          , Xu          , Uu          , Uu          , Ql          , Uu          , Ql          , Ql          , Ql          , Ql          , Ql          , Ql          , Ql          , Ql          , Ql          , Ql          , Xos         , Xos         , Cud         , Cud         , Cud         , Cud         , Ql          , Qlf         , Ql          , Qlf         , Qlf         , Ql          , Ql          , Ql          , Ql          , Xos         , Xos         , Ql          , Ql          
Xu          , Ds          , Ds          , Dd^Vdt      , Ds          , Xu          , Ds          , Ds          , Ds          , Ds          , Ds          , Uu          , Uu^Vud      , Uu          , Ql          , Ql          , Ql          , Ql          , Ql          , Ql          , Ql          , Ql          , Ql          , Ql          , Ql          , Xos         , Xos         , Cud         , Cud         , Ql          , Ql          , Qlf         , Ql          , Ql          , Xos         , Ql          , Xos         , Xos         , Ql          , Ql          , Ql          , Qlf         
Xu          , Ds          , Ds          , Ds          , Dd^Dc       , Ds          , Ds          , Dd^Vdt      , Ds          , Ds          , Ds          , Uu          , Uu          , Uu          , Uu          , Uu          , Uu          , Uu          , Uu          , Ql          , Ql          , Qlf         , Qlf         , Ql          , Ql          , Ql          , Ql          , Xos         , Xos         , Ql          , Ql          , Ql          , Xos         , Xos         , Ql          , Xos         , Ql          , Ql          , Qlf         , Qlf         , Ql          , Ql          
Ql          , Uu          , Uu          , Ds          , Ds          , Ds          , Ds          , Ds          , Ds          , Dd^Dc       , Ds          , Ds          , Ds          , Uu          , Uu^Uf       , Uu          , Uu^Vud      , Uu          , Ql          , Ql          , Ql          , Qlf         , Qlf         , Qlf         , Ql          , Ql          , Ql          , Ql          , Ql          , Xos         , Xos         , Xos         , Ql          , Ql          , Ql          , Ql          , Ql          , Ql          , Qlf         , Qlf         , Qlf         , Qlf         
Ql          , Uu          , Ql          , Uu          , Uu          , Uu          , Uu          , Uu          , Uu          , Ds          , Uu          , Ds          , Uu          , Uu          , Uu          , Uu          , Uu          , Uu          , Ql          , Ql          , Ql          , Ql          , Qlf         , Qlf         , Qlf         , Qlf         , Ql          , Ql          , Ql          , Ql          , Ql          , Ql          , Ql          , Ql          , Ql          , Ql          , Ql          , Qlf         , Ql          , Qlf         , Qlf         , Qlf         
Ql          , Ql          , Ql          , Ql          , Ql          , Ql          , Ql          , Ql          , Ql          , Uu          , Ql          , Uu          , Ql          , Ql          , Ql          , Ql          , Ql          , Ql          , Ql          , Ql          , Ql          , Qlf         , Qlf         , Qlf         , Ql          , Ql          , Ql          , Ql          , Ql          , Ql          , Ql          , Ql          , Ql          , Ql          , Ql          , Ql          , Ql          , Ql          , Ql          , Qlf         , Qlf         , Qlf         
Ql          , Ql          , Ql          , Ql          , Ql          , Ql          , Ql          , Ql          , Ql          , Ql          , Ql          , Ql          , Ql          , Ql          , Ql          , Ql          , Ql          , Ql          , Ql          , Ql          , Ql          , Qlf         , Qlf         , Qlf         , Ql          , Ql          , Ql          , Ql          , Ql          , Ql          , Ql          , Ql          , Ql          , Ql          , Ql          , Ql          , Ql          , Ql          , Ql          , Ql          , Ql          , Ql          
