border_size=1
usage=map

Hh^Fp       , Hh^Fp       , Gs^Fp       , Gs^Fp       , Gs^Fp       , Gs^Fp       , Gs^Fp       , Gs^Fp       , Gs^Fp       , Gs^Fp       , Hh^Fmf      , Gs^Fmf      , Gs^Fp       , Gs^Fp       , Gs^Fp       , Gs^Fds      , Gs^Fds      , Rd          , Gs^Fds      , Gs^Fds      , Gs^Fp       , Gs^Fp       , Gs^Fp       , Gs^Fp       , Gs^Fp       , Hh^Fds      , Hh^Fds      , Hh^Fds      , Hh^Fds      , Hh^Fds      
Hh^Fp       , Hh^Fp       , Gs^Fp       , Gs^Fp       , Hh^Fds      , Gs^Fp       , Gs^Fp       , Gs^Fp       , Gs^Fp       , Gs^Fmf      , Hh^Fmf      , Gs^Fmf      , Gg^Ve       , Gs^Fp       , Gs^Fds      , Gs^Fds      , Rd          , Rd          , Gs^Fds      , Gs^Fds      , Gs^Fds      , Gs^Fp       , Gs^Fp       , Gs^Fp       , Hh^Fds      , Hh^Fds      , Hh^Fds      , Hh^Fds      , Hh^Fds      , Hh^Fds      
Gs^Fds      , Gs^Fds      , Gs^Fds      , Gg^Ve       , Gs^Fds      , Gs^Fms      , Gs^Fds      , Gs^Fp       , Gs^Fp       , Gs^Fmf      , Gs^Fp       , Gs^Fmf      , Gs^Fp       , Gs^Fp       , Gs^Fds      , Gs^Fds      , Rd          , Gs^Fds      , Ce          , Ce          , Ce          , Gs^Fp       , Gs^Fp       , Gg^Ve       , Hh^Fds      , Hh^Fds      , Hh^Fds      , Hh^Fds      , Hh^Fds      , Hh^Fds      
Gs^Fds      , Gs^Fds      , Gs^Fds      , Gs^Fds      , Gs^Fds      , Gs^Fds      , Gs^Fds      , Gs^Fmf      , Gs^Fmf      , Gs^Fp       , Gs^Fp       , Gs^Fp       , Gs^Fms      , Gs^Fp       , Gs^Fds      , Rd          , Gs^Fds      , Gs^Fds      , Ce          , 1 Ke        , Ce          , Gs^Fp       , Hh^Fds      , Hh^Fds      , Hh^Fds      , Hh^Fds      , Hh^Fds      , Hh^Fds      , Gs^Fp       , Gs^Fp       
Ww          , Ww          , Ww          , Ww          , Ww          , Gs^Fds      , Gs^Fds      , Gs^Fds      , Gs^Fds      , Gs^Fds      , Gs^Fms      , Gs^Fms      , Gs^Fds      , Gs^Fds      , Rd          , Rd          , Gs^Fds      , Gs^Fds      , Gs^Fds      , Ce          , Gs^Fms      , Hh^Fms      , Hh^Fms      , Hh^Fds      , Hh^Fms      , Hh^Fds      , Hh^Fms      , Gg^Ve       , Gs^Fp       , Gs^Fp       
Gs^Fds      , Gs^Fds      , Gs^Fds      , Gs^Fds      , Gs^Fds      , Ww          , Ww          , Gs^Fds      , Gs^Fds      , Gg^Ve       , Gs^Fds      , Gs^Fds      , Gs^Fds      , Gs^Fds      , Rd          , Gs^Fds      , Gs^Fds      , Gs^Fds      , Gs^Fp       , Gs^Fp       , Gs^Fp       , Gs^Fp       , Gs^Fms      , Hh^Fms      , Gs^Fp       , Gs^Fp       , Gs^Fp       , Gs^Fp       , Gs^Fp       , Gs^Fp       
Gs^Fds      , Gs^Fds      , Ce          , Ce          , Ce          , Gs^Fds      , Gs^Fds      , Ww          , Ww          , Gs^Fds      , Gs^Fds      , Gs^Fms      , Gs^Fds      , Rd          , Gs^Fds      , Gs^Fds      , Gs^Fds      , Gs^Fp       , Gs^Fmf      , Gs^Fmf      , Gs^Fmf      , Gs^Fp       , Gs^Fms      , Hh^Fms      , Gs^Fp       , Gs^Fp       , Gs^Fmf      , Hh^Fmf      , Hh^Fmf      , Gs^Fp       
Gs^Fds      , Gs^Fms      , Ce          , 5 Ke        , Ce          , Gs^Fms      , Gs^Fds      , Ss          , Ww          , Ww          , Ww          , Gs^Fds      , Rd          , Rd          , Gs^Fds      , Gs^Fds      , Gs^Fp       , Gs^Fp       , Gs^Fp       , Gs^Fmf      , Gs^Fp       , Gs^Fp       , Gg^Ve       , Gs^Fp       , Gs^Fp       , Gs^Fp       , Gs^Fmf      , Hh^Fmf      , Gs^Fp       , Gs^Fp       
Gs^Fms      , Gs^Fms      , Gs^Fms      , Ce          , Gs^Fds      , Gs^Fds      , Ww          , Ww          , Ss          , Ss          , Rd          , Ww^Bw/      , Ww          , Gs^Fds      , Gs^Fds      , Gg^Ve       , Gs^Fds      , Gs^Fds      , Gs^Fms      , Gs^Fp       , Gs^Fp       , Gs^Fmw      , Gs^Fp       , Gs^Fp       , Gs^Fp       , Gs^Fp       , Gs^Fp       , Gs^Fmf      , Gs^Fp       , Gs^Fp       
Gs^Fms      , Gg^Ve       , Gs^Fds      , Gs^Fds      , Ww          , Ww          , Gs^Fds      , Gs^Fds      , Gs^Fds      , Rd          , Gs^Fds      , Gs^Fds      , Ww          , Ww          , Ww          , Gs^Fds      , Ww          , Gs^Fds      , Gs^Fds      , Gs^Fds      , Gs^Fds      , Gs^Fms      , Gs^Fms      , Gs^Fms      , Gs^Fp       , Gs^Fp       , Gs^Fp       , Gs^Fp       , Gs^Fp       , Gs^Fp       
Gs^Fds      , Gs^Fms      , Gs^Fds      , Ww          , Gs^Fds      , Gs^Fds      , Gg^Wm       , Gs^Fds      , Rd          , Rd          , Gs^Fds      , Gs^Fds      , Gs^Fds      , Ww          , Gs^Fds      , Ww          , Gs^Fds      , Ww          , Ww          , Gs^Fds      , Gs^Fds      , Gs^Fds      , Gs^Fds      , Gs^Fds      , Gs^Fds      , Gs^Fp       , Gg^Ve       , Gs^Fp       , Gs^Fms      , Gs^Fp       
Gs^Fds      , Gs^Fds      , Ww          , Ww          , Gs^Fds      , Gs^Fds      , Gs^Fds      , Gs^Fds      , Rd          , Gs^Fds      , Gg^Ve       , Gs^Fds      , Gs^Fds      , Gs^Fds      , Gs^Fds      , Gs^Fds      , Gs^Fds      , Ww          , Ww          , Ww          , Ww          , Gs^Fds      , Ww          , Gs^Fds      , Gs^Fds      , Gs^Fds      , Gs^Fds      , Gs^Fp       , Gs^Fds      , Gs^Fp       
Ww          , Ww          , Cv          , Ss          , Gs^Fds      , Gs^Fds      , Gg^Fet      , Rd          , Gg^Fet      , Gs^Fp       , Gs^Fp       , Gs^Fp       , Cv          , Gs^Fp       , Gs^Fp       , Gs^Fp       , Gs^Fds      , Ss          , Ss          , Ss          , Ss          , Ww          , Gg^Ve       , Ww          , Ww          , Gs^Fds      , Gs^Fds      , Gs^Fds      , Ww          , Gs^Fds      
Ss          , Ss          , Gs^Fds      , Gs^Fds      , Gs^Fds      , Gs^Fds      , Cv          , Rd          , Cv          , Gs^Fds      , Gs^Fds      , Gs^Fds      , Gs^Fds      , Gs^Fp       , Gs^Fp       , Gs^Fp       , Gs^Fp       , Gs^Fds      , Gs^Fds      , Gs^Fds      , Gs^Fds      , Gs^Fds      , Gs^Fms      , Gs^Fds      , Gs^Fds      , Ww          , Ww          , Ww          , Gs^Fds      , Ww          
Gs^Fds      , Gs^Fds      , Cv          , Cv          , Cv          , Cv          , Ggf         , Cv          , Ggf         , Cv          , Cv          , Cv          , Cv          , Gs^Fds      , Gs^Fds      , Gs^Fp       , Gs^Fp       , Gg^Ve       , Gs^Fp       , Gs^Fds      , Gs^Fp       , Gs^Fds      , Gs^Fms      , Gs^Fds      , Gg^Wm       , Ggf         , Gs^Fds      , Gs^Fds      , Gg^Ve       , Gs^Fds      
Cv          , Cv          , Ggf         , Ggf         , Ggf         , Ggf         , Cv          , Ggf         , Cv          , Ggf         , Ggf         , Ggf         , Ggf         , Cv          , Cv          , Gs^Fds      , Gs^Fds      , Gs^Fp       , Gs^Fp       , Gs^Fp       , Cv          , Gs^Fp       , Gs^Fp       , Gs^Fp       , Gs^Fp       , Ggf         , Ggf         , Gs^Fds      , Gs^Fds      , Gs^Fds      
Ggf         , Ggf         , Ggf         , Ggf         , Ggf         , Ggf         , Ggf         , Ggf         , Ggf         , Ggf         , Ggf         , Ggf         , Ggf         , Ggf         , Ggf         , Cv          , Gs^Fds      , Gs^Fms      , Gs^Fms      , Gs^Fp       , Gs^Fmf      , Gs^Fp       , Gs^Fp       , Ggf         , Ggf         , Ggf         , Gg^Fet      , Gs^Fds      , Gs^Fds      , Gs^Fds      
Ggf         , Ggf         , Ggf         , Ggf         , Ggf         , Ggf         , Cv          , Cv          , Cv          , Ggf         , Ggf         , Ggf         , Cv          , Ggf         , Ggf         , Cv          , Cv          , Gs^Fds      , Gs^Fms      , Gs^Fp       , Gs^Fmf      , Gs^Fmf      , Gs^Fp       , Ggf         , Ggf         , Rp^Vhc      , Gs^Fmf      , Gs^Fp       , Gs^Fp       , Gs^Fp       
Ggf         , Ggf         , Ggf         , Ggf         , Ggf         , Ggf         , Cv          , 4 Kv        , Cv          , Ggf         , Ggf         , Cv          , Ggf         , Cv          , Ggf         , Ggf         , Cv          , Gs^Fds      , Gs^Fp       , Gs^Fp       , Gs^Fmf      , Gs^Fmf      , Gs^Fp       , Ggf         , Ggf         , Ggf         , Ce          , Gs^Fp       , Gs^Fp       , Gs^Fp       
Ggf         , Ggf         , Ggf         , Cv          , Ggf         , Ggf         , Ggf         , Cv          , Ggf         , Ggf         , Ggf         , Cv          , Cv          , Cv          , Ggf         , Ggf         , Cv          , Gs^Fds      , Gs^Fms      , Gs^Fp       , Cv          , Gs^Fp       , Gs^Fp       , Ggf         , Gs^Fp       , Ce          , 2 Ke        , Ce          , Gs^Fp       , Gs^Fp       
Ggf         , Cv          , Ggf         , Ggf         , Ggf         , Cv          , Ggf         , Ggf         , Ggf         , Cv          , Ggf         , Ggf         , Ggf         , Ggf         , Ggf         , Cv          , Gs^Fds      , Gs^Fds      , Gs^Fp       , Gs^Fp       , Gs^Fp       , Gs^Fmf      , Gs^Fp       , Gs^Fp       , Gs^Fp       , Ce          , Ce          , Ce          , Gs^Fp       , Gs^Fp       
Cv          , Ggf         , Ggf         , Cv          , Ggf         , Ggf         , Cv          , Ggf         , Cv          , Ggf         , Ggf         , Cv          , Ggf         , Ggf         , Cv          , Cv          , Gs^Fds      , Gs^Fp       , Gg          , Gs^Fp       , Gs^Fp       , Gs^Fp       , Gs^Fmf      , Gs^Fp       , Gs^Fmf      , Gs^Fp       , Gs^Fp       , Gs^Fp       , Gs^Fp       , Gs^Fp       
Gs^Fds      , Cv          , Cv          , Ggf         , Cv          , Ggf         , Ggf         , Ggf         , Ggf         , Ggf         , Cv          , Ggf         , Cv          , Cv          , Ggf         , Ggf         , Ggf         , Gg          , Ggf         , Gg          , Gg          , Gs^Fp       , Gs^Fp       , Gs^Fmf      , Gs^Fp       , Gs^Fp       , Gs^Fp       , Gs^Fp       , Gs^Fp       , Gs^Fp       
Gs^Fp       , Gs^Fds      , Gs^Fds      , Cv          , Gs^Fds      , Cv          , Cv          , Cv          , Cv          , Cv          , Gs^Fds      , Cv          , Gs^Fds      , Gs^Fds      , Gs^Fp       , Ggf         , Gg          , Gg          , Re^Gvs      , Gg          , Gg          , Gs^Fp       , Gs^Fms      , Gs^Fp       , Gs^Fp       , Gs^Fp       , Hh^Fmf      , Hh^Fmf      , Hh^Fmf      , Gs^Fp       
Gs^Fp       , Gs^Fp       , Gs^Fp       , Gs^Fds      , Gs^Fms      , Gs^Fds      , Gg^Fet      , Rd          , Gg^Fet      , Gs^Fds      , Gs^Fms      , Gs^Fds      , Gs^Fp       , Gs^Fp       , Gs^Fp       , Gs^Fp       , Gg          , Re^Gvs      , Gg          , Gg          , Gs^Fp       , Gs^Fms      , Gs^Fms      , Gs^Fms      , Gs^Fp       , Gs^Fp       , Gs^Fmf      , Hh^Fmf      , Hh^Fmf      , Gs^Fp       
Gs^Fp       , Gs^Fp       , Gs^Ft       , Gs^Fp       , Gs^Fp       , Gs^Fp       , Cv          , Rd          , Cv          , Gs^Fp       , Gs^Fp       , Gs^Fms      , Gs^Fp       , Gs^Fp       , Gs^Fp       , Gs^Fp       , Gs^Fms      , Gg          , Gs^Fms      , Gs^Fms      , Gg^Ve       , Gs^Fp       , Gs^Fp       , Gs^Fmf      , Gs^Fp       , Gg^Ve       , Gs^Fp       , Gs^Fp       , Gs^Fp       , Gs^Fp       
Gs^Fp       , Gs^Fp       , Ce          , Ce          , Ce          , Gs^Fds      , Gg          , Rd          , Gg          , Gs^Fp       , Gs^Fp       , Gs^Fms      , Gs^Fp       , Gg^Ve       , Gs^Fp       , Gs^Fp       , Gs^Fms      , Gg          , Gs^Fms      , Gs^Fp       , Gs^Fmf      , Gs^Fmf      , Gs^Fp       , Gs^Fp       , Gs^Fp       , Gs^Fp       , Gs^Fp       , Gs^Fp       , Gs^Fp       , Gs^Fp       
Gs^Fp       , Gs^Fp       , Ce          , 3 Ke        , Ce          , Gg          , Rd          , Rd          , Gg          , Gs^Fds      , Gs^Fp       , Gs^Fp       , Gs^Fp       , Gs^Fp       , Gs^Fms      , Gs^Fp       , Gg          , Gg          , Gs^Fms      , Gs^Fp       , Hh^Fmf      , Hh^Fmf      , Gs^Fp       , Gs^Fp       , Gs^Fp       , Gs^Fp       , Gs^Fp       , Gs^Fmf      , Gs^Fp       , Gs^Fp       
Gs^Fp       , Gs^Fp       , Gs^Fp       , Ce          , Gg          , Gg          , Rd          , Gg          , Gs^Fds      , Gs^Fp       , Gg          , Gs^Fms      , Gg          , Gg          , Gg          , Gg          , Gg          , Gs^Fms      , Gs^Fp       , Gs^Fp       , Gs^Fp       , Gs^Fmf      , Gs^Fp       , Gg^Ve       , Gs^Fp       , Gs^Fp       , Gs^Fms      , Gs^Fms      , Gg^Ve       , Gs^Fp       
Gs^Fp       , Gs^Fp       , Gs^Fp       , Gs^Fp       , Gg          , Rd          , Gg          , Gg          , Gg          , Gg          , Gs^Fp       , Gg          , Gs^Fp       , Gs^Fp       , Gg          , Gs^Fp       , Gs^Fp       , Gg          , Gg          , Gs^Fp       , Gg          , Gs^Fp       , Gg          , Gs^Fp       , Gg          , Gs^Fp       , Gs^Fp       , Gs^Fms      , Gs^Fp       , Gs^Fp       
